shots,bp_converged,postprocessing_count,max_bp_iters,id,bias,per,code_name
100,8,92,10,10[0.006],0.5,[0.006],FloquetColourCode
100,12,88,10,10[0.006],0.5,[0.006],FloquetColourCode
200,26,174,10,10[0.006],0.5,[0.006],FloquetColourCode
200,23,177,10,10[0.006],0.5,[0.006],FloquetColourCode
200,20,180,10,10[0.006],0.5,[0.006],FloquetColourCode
400,64,336,10,10[0.006],0.5,[0.006],FloquetColourCode
400,47,353,10,10[0.006],0.5,[0.006],FloquetColourCode
800,91,709,10,10[0.006],0.5,[0.006],FloquetColourCode
1200,147,1053,10,10[0.006],0.5,[0.006],FloquetColourCode
1200,152,1048,10,10[0.006],0.5,[0.006],FloquetColourCode
2400,320,2080,10,10[0.006],0.5,[0.006],FloquetColourCode
2400,300,2100,10,10[0.006],0.5,[0.006],FloquetColourCode
122,16,106,10,10[0.006],0.5,[0.006],FloquetColourCode
732,88,644,10,10[0.006],0.5,[0.006],FloquetColourCode
4800,600,4200,10,10[0.006],0.5,[0.006],FloquetColourCode
7200,896,6304,10,10[0.006],0.5,[0.006],FloquetColourCode
6829,923,5906,10,10[0.006],0.5,[0.006],FloquetColourCode
4392,551,3841,10,10[0.006],0.5,[0.006],FloquetColourCode
7200,968,6232,10,10[0.006],0.5,[0.006],FloquetColourCode
7139,925,6214,10,10[0.006],0.5,[0.006],FloquetColourCode
7139,943,6196,10,10[0.006],0.5,[0.006],FloquetColourCode
7571,960,6611,10,10[0.006],0.5,[0.006],FloquetColourCode
6626,879,5747,10,10[0.006],0.5,[0.006],FloquetColourCode
100,4,96,10,10[0.007],0.5,[0.007],FloquetColourCode
100,8,92,10,10[0.007],0.5,[0.007],FloquetColourCode
200,13,187,10,10[0.007],0.5,[0.007],FloquetColourCode
200,8,192,10,10[0.007],0.5,[0.007],FloquetColourCode
200,13,187,10,10[0.007],0.5,[0.007],FloquetColourCode
400,26,374,10,10[0.007],0.5,[0.007],FloquetColourCode
400,34,366,10,10[0.007],0.5,[0.007],FloquetColourCode
800,52,748,10,10[0.007],0.5,[0.007],FloquetColourCode
1200,68,1132,10,10[0.007],0.5,[0.007],FloquetColourCode
400,21,379,10,10[0.007],0.5,[0.007],FloquetColourCode
1200,60,1140,10,10[0.007],0.5,[0.007],FloquetColourCode
2400,127,2273,10,10[0.007],0.5,[0.007],FloquetColourCode
2400,144,2256,10,10[0.007],0.5,[0.007],FloquetColourCode
100,5,95,10,10[0.008],0.5,[0.008],FloquetColourCode
100,3,97,10,10[0.008],0.5,[0.008],FloquetColourCode
200,5,195,10,10[0.008],0.5,[0.008],FloquetColourCode
200,5,195,10,10[0.008],0.5,[0.008],FloquetColourCode
200,7,193,10,10[0.008],0.5,[0.008],FloquetColourCode
400,15,385,10,10[0.008],0.5,[0.008],FloquetColourCode
400,5,395,10,10[0.008],0.5,[0.008],FloquetColourCode
800,19,781,10,10[0.008],0.5,[0.008],FloquetColourCode
1200,25,1175,10,10[0.008],0.5,[0.008],FloquetColourCode
400,13,387,10,10[0.008],0.5,[0.008],FloquetColourCode
1200,24,1176,10,10[0.008],0.5,[0.008],FloquetColourCode
2400,63,2337,10,10[0.008],0.5,[0.008],FloquetColourCode
2400,59,2341,10,10[0.008],0.5,[0.008],FloquetColourCode
100,0,100,10,10[0.009],0.5,[0.009],FloquetColourCode
100,0,100,10,10[0.009],0.5,[0.009],FloquetColourCode
200,1,199,10,10[0.009],0.5,[0.009],FloquetColourCode
200,2,198,10,10[0.009],0.5,[0.009],FloquetColourCode
200,3,197,10,10[0.009],0.5,[0.009],FloquetColourCode
400,7,393,10,10[0.009],0.5,[0.009],FloquetColourCode
400,4,396,10,10[0.009],0.5,[0.009],FloquetColourCode
205,2,203,10,10[0.009],0.5,[0.009],FloquetColourCode
111,1,110,10,10[0.009],0.5,[0.009],FloquetColourCode
136,2,134,10,10[0.009],0.5,[0.009],FloquetColourCode
23,0,23,10,10[0.009],0.5,[0.009],FloquetColourCode
48,0,48,10,10[0.009],0.5,[0.009],FloquetColourCode
159,1,158,10,10[0.009],0.5,[0.009],FloquetColourCode
800,9,791,10,10[0.009],0.5,[0.009],FloquetColourCode
695,9,686,10,10[0.009],0.5,[0.009],FloquetColourCode
58,0,58,10,10[0.009],0.5,[0.009],FloquetColourCode
14,0,14,10,10[0.009],0.5,[0.009],FloquetColourCode
42,1,41,10,10[0.009],0.5,[0.009],FloquetColourCode
16,0,16,10,10[0.009],0.5,[0.009],FloquetColourCode
17,0,17,10,10[0.009],0.5,[0.009],FloquetColourCode
101,0,101,10,10[0.009],0.5,[0.009],FloquetColourCode
15,0,15,10,10[0.009],0.5,[0.009],FloquetColourCode
20,0,20,10,10[0.009],0.5,[0.009],FloquetColourCode
586,2,584,10,10[0.009],0.5,[0.009],FloquetColourCode
100,1,99,10,10[0.01],0.5,[0.01],FloquetColourCode
100,0,100,10,10[0.01],0.5,[0.01],FloquetColourCode
200,0,200,10,10[0.01],0.5,[0.01],FloquetColourCode
200,1,199,10,10[0.01],0.5,[0.01],FloquetColourCode
200,1,199,10,10[0.01],0.5,[0.01],FloquetColourCode
139,1,138,10,10[0.01],0.5,[0.01],FloquetColourCode
400,2,398,10,10[0.01],0.5,[0.01],FloquetColourCode
295,2,293,10,10[0.01],0.5,[0.01],FloquetColourCode
595,6,589,10,10[0.01],0.5,[0.01],FloquetColourCode
235,0,235,10,10[0.01],0.5,[0.01],FloquetColourCode
25,2,23,10,10[0.01],0.5,[0.01],FloquetColourCode
61,1,60,10,10[0.01],0.5,[0.01],FloquetColourCode
28,0,28,10,10[0.01],0.5,[0.01],FloquetColourCode
209,0,209,10,10[0.01],0.5,[0.01],FloquetColourCode
100,1,99,10,10[0.011],0.5,[0.011],FloquetColourCode
100,0,100,10,10[0.011],0.5,[0.011],FloquetColourCode
200,0,200,10,10[0.011],0.5,[0.011],FloquetColourCode
200,0,200,10,10[0.011],0.5,[0.011],FloquetColourCode
200,0,200,10,10[0.011],0.5,[0.011],FloquetColourCode
400,0,400,10,10[0.011],0.5,[0.011],FloquetColourCode
766,1,765,10,10[0.011],0.5,[0.011],FloquetColourCode
100,0,100,10,10[0.012],0.5,[0.012],FloquetColourCode
100,0,100,10,10[0.012],0.5,[0.012],FloquetColourCode
150,0,150,10,10[0.012],0.5,[0.012],FloquetColourCode
200,0,200,10,10[0.012],0.5,[0.012],FloquetColourCode
200,0,200,10,10[0.012],0.5,[0.012],FloquetColourCode
16,0,16,10,10[0.012],0.5,[0.012],FloquetColourCode
61,0,61,10,10[0.012],0.5,[0.012],FloquetColourCode
400,0,400,10,10[0.012],0.5,[0.012],FloquetColourCode
100,0,100,10,10[0.013],0.5,[0.013],FloquetColourCode
100,0,100,10,10[0.013],0.5,[0.013],FloquetColourCode
200,0,200,10,10[0.013],0.5,[0.013],FloquetColourCode
200,0,200,10,10[0.013],0.5,[0.013],FloquetColourCode
90,0,90,10,10[0.013],0.5,[0.013],FloquetColourCode
64,0,64,10,10[0.013],0.5,[0.013],FloquetColourCode
28,0,28,10,10[0.013],0.5,[0.013],FloquetColourCode
28,0,28,10,10[0.013],0.5,[0.013],FloquetColourCode
30,0,30,10,10[0.013],0.5,[0.013],FloquetColourCode
21,0,21,10,10[0.013],0.5,[0.013],FloquetColourCode
13,0,13,10,10[0.013],0.5,[0.013],FloquetColourCode
100,0,100,10,10[0.014],0.5,[0.014],FloquetColourCode
47,0,47,10,10[0.014],0.5,[0.014],FloquetColourCode
200,0,200,10,10[0.014],0.5,[0.014],FloquetColourCode
200,0,200,10,10[0.014],0.5,[0.014],FloquetColourCode
215,0,215,10,10[0.014],0.5,[0.014],FloquetColourCode
100,22,78,20,20[0.006],0.5,[0.006],FloquetColourCode
100,20,80,20,20[0.006],0.5,[0.006],FloquetColourCode
200,37,163,20,20[0.006],0.5,[0.006],FloquetColourCode
200,39,161,20,20[0.006],0.5,[0.006],FloquetColourCode
200,31,169,20,20[0.006],0.5,[0.006],FloquetColourCode
400,64,336,20,20[0.006],0.5,[0.006],FloquetColourCode
400,60,340,20,20[0.006],0.5,[0.006],FloquetColourCode
800,139,661,20,20[0.006],0.5,[0.006],FloquetColourCode
1200,205,995,20,20[0.006],0.5,[0.006],FloquetColourCode
400,75,325,20,20[0.006],0.5,[0.006],FloquetColourCode
1200,211,989,20,20[0.006],0.5,[0.006],FloquetColourCode
2400,423,1977,20,20[0.006],0.5,[0.006],FloquetColourCode
2400,386,2014,20,20[0.006],0.5,[0.006],FloquetColourCode
100,9,91,20,20[0.007],0.5,[0.007],FloquetColourCode
100,8,92,20,20[0.007],0.5,[0.007],FloquetColourCode
200,17,183,20,20[0.007],0.5,[0.007],FloquetColourCode
200,19,181,20,20[0.007],0.5,[0.007],FloquetColourCode
200,17,183,20,20[0.007],0.5,[0.007],FloquetColourCode
400,30,370,20,20[0.007],0.5,[0.007],FloquetColourCode
400,39,361,20,20[0.007],0.5,[0.007],FloquetColourCode
800,83,717,20,20[0.007],0.5,[0.007],FloquetColourCode
1200,95,1105,20,20[0.007],0.5,[0.007],FloquetColourCode
1200,105,1095,20,20[0.007],0.5,[0.007],FloquetColourCode
400,41,359,20,20[0.007],0.5,[0.007],FloquetColourCode
2400,221,2179,20,20[0.007],0.5,[0.007],FloquetColourCode
2400,227,2173,20,20[0.007],0.5,[0.007],FloquetColourCode
100,3,97,20,20[0.008],0.5,[0.008],FloquetColourCode
100,6,94,20,20[0.008],0.5,[0.008],FloquetColourCode
200,11,189,20,20[0.008],0.5,[0.008],FloquetColourCode
200,5,195,20,20[0.008],0.5,[0.008],FloquetColourCode
200,8,192,20,20[0.008],0.5,[0.008],FloquetColourCode
400,19,381,20,20[0.008],0.5,[0.008],FloquetColourCode
400,16,384,20,20[0.008],0.5,[0.008],FloquetColourCode
800,19,781,20,20[0.008],0.5,[0.008],FloquetColourCode
1200,50,1150,20,20[0.008],0.5,[0.008],FloquetColourCode
1200,58,1142,20,20[0.008],0.5,[0.008],FloquetColourCode
2400,101,2299,20,20[0.008],0.5,[0.008],FloquetColourCode
100,3,97,20,20[0.009],0.5,[0.009],FloquetColourCode
100,4,96,20,20[0.009],0.5,[0.009],FloquetColourCode
200,5,195,20,20[0.009],0.5,[0.009],FloquetColourCode
200,3,197,20,20[0.009],0.5,[0.009],FloquetColourCode
200,3,197,20,20[0.009],0.5,[0.009],FloquetColourCode
400,9,391,20,20[0.009],0.5,[0.009],FloquetColourCode
400,1,399,20,20[0.009],0.5,[0.009],FloquetColourCode
800,14,786,20,20[0.009],0.5,[0.009],FloquetColourCode
983,11,972,20,20[0.009],0.5,[0.009],FloquetColourCode
463,6,457,20,20[0.009],0.5,[0.009],FloquetColourCode
1200,18,1182,20,20[0.009],0.5,[0.009],FloquetColourCode
316,6,310,20,20[0.009],0.5,[0.009],FloquetColourCode
100,1,99,20,20[0.01],0.5,[0.01],FloquetColourCode
100,1,99,20,20[0.01],0.5,[0.01],FloquetColourCode
200,1,199,20,20[0.01],0.5,[0.01],FloquetColourCode
200,2,198,20,20[0.01],0.5,[0.01],FloquetColourCode
200,1,199,20,20[0.01],0.5,[0.01],FloquetColourCode
173,0,173,20,20[0.01],0.5,[0.01],FloquetColourCode
207,3,204,20,20[0.01],0.5,[0.01],FloquetColourCode
400,1,399,20,20[0.01],0.5,[0.01],FloquetColourCode
800,9,791,20,20[0.01],0.5,[0.01],FloquetColourCode
100,0,100,20,20[0.011],0.5,[0.011],FloquetColourCode
100,0,100,20,20[0.011],0.5,[0.011],FloquetColourCode
200,1,199,20,20[0.011],0.5,[0.011],FloquetColourCode
200,0,200,20,20[0.011],0.5,[0.011],FloquetColourCode
200,0,200,20,20[0.011],0.5,[0.011],FloquetColourCode
121,0,121,20,20[0.011],0.5,[0.011],FloquetColourCode
400,1,399,20,20[0.011],0.5,[0.011],FloquetColourCode
329,1,328,20,20[0.011],0.5,[0.011],FloquetColourCode
100,0,100,20,20[0.012],0.5,[0.012],FloquetColourCode
100,0,100,20,20[0.012],0.5,[0.012],FloquetColourCode
200,0,200,20,20[0.012],0.5,[0.012],FloquetColourCode
200,0,200,20,20[0.012],0.5,[0.012],FloquetColourCode
262,0,262,20,20[0.012],0.5,[0.012],FloquetColourCode
318,0,318,20,20[0.012],0.5,[0.012],FloquetColourCode
48,0,48,20,20[0.012],0.5,[0.012],FloquetColourCode
100,0,100,20,20[0.013],0.5,[0.013],FloquetColourCode
100,0,100,20,20[0.013],0.5,[0.013],FloquetColourCode
35,0,35,20,20[0.013],0.5,[0.013],FloquetColourCode
200,0,200,20,20[0.013],0.5,[0.013],FloquetColourCode
21,0,21,20,20[0.013],0.5,[0.013],FloquetColourCode
200,0,200,20,20[0.013],0.5,[0.013],FloquetColourCode
400,0,400,20,20[0.013],0.5,[0.013],FloquetColourCode
100,0,100,20,20[0.014],0.5,[0.014],FloquetColourCode
100,0,100,20,20[0.014],0.5,[0.014],FloquetColourCode
200,0,200,20,20[0.014],0.5,[0.014],FloquetColourCode
200,0,200,20,20[0.014],0.5,[0.014],FloquetColourCode
124,0,124,20,20[0.014],0.5,[0.014],FloquetColourCode
100,21,79,50,50[0.006],0.5,[0.006],FloquetColourCode
100,16,84,50,50[0.006],0.5,[0.006],FloquetColourCode
200,38,162,50,50[0.006],0.5,[0.006],FloquetColourCode
200,44,156,50,50[0.006],0.5,[0.006],FloquetColourCode
200,37,163,50,50[0.006],0.5,[0.006],FloquetColourCode
400,65,335,50,50[0.006],0.5,[0.006],FloquetColourCode
400,69,331,50,50[0.006],0.5,[0.006],FloquetColourCode
800,155,645,50,50[0.006],0.5,[0.006],FloquetColourCode
400,73,327,50,50[0.006],0.5,[0.006],FloquetColourCode
1200,255,945,50,50[0.006],0.5,[0.006],FloquetColourCode
1200,257,943,50,50[0.006],0.5,[0.006],FloquetColourCode
2400,428,1972,50,50[0.006],0.5,[0.006],FloquetColourCode
2400,479,1921,50,50[0.006],0.5,[0.006],FloquetColourCode
100,14,86,50,50[0.007],0.5,[0.007],FloquetColourCode
100,11,89,50,50[0.007],0.5,[0.007],FloquetColourCode
200,24,176,50,50[0.007],0.5,[0.007],FloquetColourCode
200,14,186,50,50[0.007],0.5,[0.007],FloquetColourCode
200,20,180,50,50[0.007],0.5,[0.007],FloquetColourCode
400,37,363,50,50[0.007],0.5,[0.007],FloquetColourCode
400,36,364,50,50[0.007],0.5,[0.007],FloquetColourCode
800,102,698,50,50[0.007],0.5,[0.007],FloquetColourCode
400,33,367,50,50[0.007],0.5,[0.007],FloquetColourCode
660,72,588,50,50[0.007],0.5,[0.007],FloquetColourCode
1200,151,1049,50,50[0.007],0.5,[0.007],FloquetColourCode
1200,135,1065,50,50[0.007],0.5,[0.007],FloquetColourCode
665,71,594,50,50[0.007],0.5,[0.007],FloquetColourCode
1740,196,1544,50,50[0.007],0.5,[0.007],FloquetColourCode
1735,197,1538,50,50[0.007],0.5,[0.007],FloquetColourCode
100,3,97,50,50[0.008],0.5,[0.008],FloquetColourCode
100,6,94,50,50[0.008],0.5,[0.008],FloquetColourCode
200,10,190,50,50[0.008],0.5,[0.008],FloquetColourCode
200,6,194,50,50[0.008],0.5,[0.008],FloquetColourCode
200,11,189,50,50[0.008],0.5,[0.008],FloquetColourCode
400,22,378,50,50[0.008],0.5,[0.008],FloquetColourCode
400,13,387,50,50[0.008],0.5,[0.008],FloquetColourCode
15,1,14,50,50[0.008],0.5,[0.008],FloquetColourCode
333,16,317,50,50[0.008],0.5,[0.008],FloquetColourCode
800,51,749,50,50[0.008],0.5,[0.008],FloquetColourCode
1200,67,1133,50,50[0.008],0.5,[0.008],FloquetColourCode
1200,53,1147,50,50[0.008],0.5,[0.008],FloquetColourCode
2067,111,1956,50,50[0.008],0.5,[0.008],FloquetColourCode
1946,91,1855,50,50[0.008],0.5,[0.008],FloquetColourCode
100,3,97,50,50[0.009],0.5,[0.009],FloquetColourCode
100,1,99,50,50[0.009],0.5,[0.009],FloquetColourCode
200,10,190,50,50[0.009],0.5,[0.009],FloquetColourCode
200,4,196,50,50[0.009],0.5,[0.009],FloquetColourCode
200,4,196,50,50[0.009],0.5,[0.009],FloquetColourCode
400,2,398,50,50[0.009],0.5,[0.009],FloquetColourCode
400,10,390,50,50[0.009],0.5,[0.009],FloquetColourCode
858,21,837,50,50[0.009],0.5,[0.009],FloquetColourCode
800,19,781,50,50[0.009],0.5,[0.009],FloquetColourCode
867,24,843,50,50[0.009],0.5,[0.009],FloquetColourCode
632,12,620,50,50[0.009],0.5,[0.009],FloquetColourCode
100,0,100,50,50[0.01],0.5,[0.01],FloquetColourCode
100,0,100,50,50[0.01],0.5,[0.01],FloquetColourCode
200,2,198,50,50[0.01],0.5,[0.01],FloquetColourCode
200,2,198,50,50[0.01],0.5,[0.01],FloquetColourCode
200,1,199,50,50[0.01],0.5,[0.01],FloquetColourCode
179,1,178,50,50[0.01],0.5,[0.01],FloquetColourCode
171,2,169,50,50[0.01],0.5,[0.01],FloquetColourCode
400,2,398,50,50[0.01],0.5,[0.01],FloquetColourCode
400,1,399,50,50[0.01],0.5,[0.01],FloquetColourCode
800,9,791,50,50[0.01],0.5,[0.01],FloquetColourCode
100,0,100,50,50[0.011],0.5,[0.011],FloquetColourCode
100,0,100,50,50[0.011],0.5,[0.011],FloquetColourCode
200,0,200,50,50[0.011],0.5,[0.011],FloquetColourCode
200,1,199,50,50[0.011],0.5,[0.011],FloquetColourCode
25,0,25,50,50[0.011],0.5,[0.011],FloquetColourCode
200,1,199,50,50[0.011],0.5,[0.011],FloquetColourCode
29,0,29,50,50[0.011],0.5,[0.011],FloquetColourCode
65,1,64,50,50[0.011],0.5,[0.011],FloquetColourCode
60,0,60,50,50[0.011],0.5,[0.011],FloquetColourCode
400,3,397,50,50[0.011],0.5,[0.011],FloquetColourCode
595,5,590,50,50[0.011],0.5,[0.011],FloquetColourCode
100,1,99,50,50[0.012],0.5,[0.012],FloquetColourCode
100,0,100,50,50[0.012],0.5,[0.012],FloquetColourCode
200,0,200,50,50[0.012],0.5,[0.012],FloquetColourCode
200,1,199,50,50[0.012],0.5,[0.012],FloquetColourCode
200,0,200,50,50[0.012],0.5,[0.012],FloquetColourCode
275,0,275,50,50[0.012],0.5,[0.012],FloquetColourCode
400,0,400,50,50[0.012],0.5,[0.012],FloquetColourCode
100,1,99,50,50[0.013],0.5,[0.013],FloquetColourCode
100,0,100,50,50[0.013],0.5,[0.013],FloquetColourCode
200,0,200,50,50[0.013],0.5,[0.013],FloquetColourCode
200,0,200,50,50[0.013],0.5,[0.013],FloquetColourCode
385,0,385,50,50[0.013],0.5,[0.013],FloquetColourCode
100,0,100,50,50[0.014],0.5,[0.014],FloquetColourCode
100,0,100,50,50[0.014],0.5,[0.014],FloquetColourCode
67,0,67,50,50[0.014],0.5,[0.014],FloquetColourCode
6,0,6,50,50[0.014],0.5,[0.014],FloquetColourCode
200,0,200,50,50[0.014],0.5,[0.014],FloquetColourCode
200,0,200,50,50[0.014],0.5,[0.014],FloquetColourCode
100,14,86,200,200[0.006],0.5,[0.006],FloquetColourCode
100,19,81,200,200[0.006],0.5,[0.006],FloquetColourCode
200,44,156,200,200[0.006],0.5,[0.006],FloquetColourCode
200,38,162,200,200[0.006],0.5,[0.006],FloquetColourCode
200,37,163,200,200[0.006],0.5,[0.006],FloquetColourCode
400,74,326,200,200[0.006],0.5,[0.006],FloquetColourCode
340,65,275,200,200[0.006],0.5,[0.006],FloquetColourCode
400,83,317,200,200[0.006],0.5,[0.006],FloquetColourCode
425,72,353,200,200[0.006],0.5,[0.006],FloquetColourCode
692,128,564,200,200[0.006],0.5,[0.006],FloquetColourCode
635,126,509,200,200[0.006],0.5,[0.006],FloquetColourCode
800,148,652,200,200[0.006],0.5,[0.006],FloquetColourCode
692,150,542,200,200[0.006],0.5,[0.006],FloquetColourCode
596,107,489,200,200[0.006],0.5,[0.006],FloquetColourCode
860,160,700,200,200[0.006],0.5,[0.006],FloquetColourCode
775,153,622,200,200[0.006],0.5,[0.006],FloquetColourCode
266,47,219,200,200[0.006],0.5,[0.006],FloquetColourCode
505,97,408,200,200[0.006],0.5,[0.006],FloquetColourCode
481,95,386,200,200[0.006],0.5,[0.006],FloquetColourCode
465,80,385,200,200[0.006],0.5,[0.006],FloquetColourCode
431,80,351,200,200[0.006],0.5,[0.006],FloquetColourCode
437,80,357,200,200[0.006],0.5,[0.006],FloquetColourCode
100,17,83,200,200[0.007],0.5,[0.007],FloquetColourCode
100,8,92,200,200[0.007],0.5,[0.007],FloquetColourCode
200,20,180,200,200[0.007],0.5,[0.007],FloquetColourCode
200,26,174,200,200[0.007],0.5,[0.007],FloquetColourCode
114,9,105,200,200[0.007],0.5,[0.007],FloquetColourCode
200,32,168,200,200[0.007],0.5,[0.007],FloquetColourCode
148,14,134,200,200[0.007],0.5,[0.007],FloquetColourCode
400,39,361,200,200[0.007],0.5,[0.007],FloquetColourCode
543,68,475,200,200[0.007],0.5,[0.007],FloquetColourCode
408,48,360,200,200[0.007],0.5,[0.007],FloquetColourCode
526,59,467,200,200[0.007],0.5,[0.007],FloquetColourCode
466,34,432,200,200[0.007],0.5,[0.007],FloquetColourCode
425,47,378,200,200[0.007],0.5,[0.007],FloquetColourCode
526,65,461,200,200[0.007],0.5,[0.007],FloquetColourCode
543,65,478,200,200[0.007],0.5,[0.007],FloquetColourCode
390,45,345,200,200[0.007],0.5,[0.007],FloquetColourCode
312,40,272,200,200[0.007],0.5,[0.007],FloquetColourCode
337,31,306,200,200[0.007],0.5,[0.007],FloquetColourCode
279,24,255,200,200[0.007],0.5,[0.007],FloquetColourCode
269,30,239,200,200[0.007],0.5,[0.007],FloquetColourCode
256,26,230,200,200[0.007],0.5,[0.007],FloquetColourCode
290,40,250,200,200[0.007],0.5,[0.007],FloquetColourCode
261,28,233,200,200[0.007],0.5,[0.007],FloquetColourCode
253,30,223,200,200[0.007],0.5,[0.007],FloquetColourCode
253,30,223,200,200[0.007],0.5,[0.007],FloquetColourCode
253,29,224,200,200[0.007],0.5,[0.007],FloquetColourCode
251,24,227,200,200[0.007],0.5,[0.007],FloquetColourCode
241,29,212,200,200[0.007],0.5,[0.007],FloquetColourCode
244,34,210,200,200[0.007],0.5,[0.007],FloquetColourCode
248,27,221,200,200[0.007],0.5,[0.007],FloquetColourCode
246,30,216,200,200[0.007],0.5,[0.007],FloquetColourCode
242,27,215,200,200[0.007],0.5,[0.007],FloquetColourCode
242,24,218,200,200[0.007],0.5,[0.007],FloquetColourCode
234,32,202,200,200[0.007],0.5,[0.007],FloquetColourCode
100,5,95,200,200[0.008],0.5,[0.008],FloquetColourCode
100,2,98,200,200[0.008],0.5,[0.008],FloquetColourCode
200,7,193,200,200[0.008],0.5,[0.008],FloquetColourCode
200,18,182,200,200[0.008],0.5,[0.008],FloquetColourCode
200,16,184,200,200[0.008],0.5,[0.008],FloquetColourCode
400,19,381,200,200[0.008],0.5,[0.008],FloquetColourCode
356,15,341,200,200[0.008],0.5,[0.008],FloquetColourCode
400,13,387,200,200[0.008],0.5,[0.008],FloquetColourCode
800,36,764,200,200[0.008],0.5,[0.008],FloquetColourCode
844,33,811,200,200[0.008],0.5,[0.008],FloquetColourCode
487,34,453,200,200[0.008],0.5,[0.008],FloquetColourCode
713,34,679,200,200[0.008],0.5,[0.008],FloquetColourCode
661,38,623,200,200[0.008],0.5,[0.008],FloquetColourCode
547,26,521,200,200[0.008],0.5,[0.008],FloquetColourCode
583,32,551,200,200[0.008],0.5,[0.008],FloquetColourCode
661,34,627,200,200[0.008],0.5,[0.008],FloquetColourCode
100,3,97,200,200[0.009],0.5,[0.009],FloquetColourCode
100,2,98,200,200[0.009],0.5,[0.009],FloquetColourCode
200,5,195,200,200[0.009],0.5,[0.009],FloquetColourCode
200,4,196,200,200[0.009],0.5,[0.009],FloquetColourCode
200,2,198,200,200[0.009],0.5,[0.009],FloquetColourCode
400,10,390,200,200[0.009],0.5,[0.009],FloquetColourCode
400,6,394,200,200[0.009],0.5,[0.009],FloquetColourCode
77,1,76,200,200[0.009],0.5,[0.009],FloquetColourCode
13,0,13,200,200[0.009],0.5,[0.009],FloquetColourCode
28,0,28,200,200[0.009],0.5,[0.009],FloquetColourCode
62,2,60,200,200[0.009],0.5,[0.009],FloquetColourCode
136,3,133,200,200[0.009],0.5,[0.009],FloquetColourCode
800,25,775,200,200[0.009],0.5,[0.009],FloquetColourCode
492,11,481,200,200[0.009],0.5,[0.009],FloquetColourCode
695,18,677,200,200[0.009],0.5,[0.009],FloquetColourCode
210,7,203,200,200[0.009],0.5,[0.009],FloquetColourCode
100,1,99,200,200[0.01],0.5,[0.01],FloquetColourCode
100,2,98,200,200[0.01],0.5,[0.01],FloquetColourCode
200,3,197,200,200[0.01],0.5,[0.01],FloquetColourCode
200,4,196,200,200[0.01],0.5,[0.01],FloquetColourCode
200,0,200,200,200[0.01],0.5,[0.01],FloquetColourCode
400,7,393,200,200[0.01],0.5,[0.01],FloquetColourCode
344,7,337,200,200[0.01],0.5,[0.01],FloquetColourCode
6,0,6,200,200[0.01],0.5,[0.01],FloquetColourCode
40,2,38,200,200[0.01],0.5,[0.01],FloquetColourCode
9,0,9,200,200[0.01],0.5,[0.01],FloquetColourCode
14,0,14,200,200[0.01],0.5,[0.01],FloquetColourCode
60,0,60,200,200[0.01],0.5,[0.01],FloquetColourCode
40,0,40,200,200[0.01],0.5,[0.01],FloquetColourCode
23,0,23,200,200[0.01],0.5,[0.01],FloquetColourCode
33,1,32,200,200[0.01],0.5,[0.01],FloquetColourCode
13,0,13,200,200[0.01],0.5,[0.01],FloquetColourCode
18,0,18,200,200[0.01],0.5,[0.01],FloquetColourCode
750,11,739,200,200[0.01],0.5,[0.01],FloquetColourCode
215,0,215,200,200[0.01],0.5,[0.01],FloquetColourCode
83,1,82,200,200[0.01],0.5,[0.01],FloquetColourCode
100,0,100,200,200[0.011],0.5,[0.011],FloquetColourCode
100,0,100,200,200[0.011],0.5,[0.011],FloquetColourCode
200,1,199,200,200[0.011],0.5,[0.011],FloquetColourCode
200,1,199,200,200[0.011],0.5,[0.011],FloquetColourCode
173,1,172,200,200[0.011],0.5,[0.011],FloquetColourCode
200,1,199,200,200[0.011],0.5,[0.011],FloquetColourCode
400,0,400,200,200[0.011],0.5,[0.011],FloquetColourCode
800,3,797,200,200[0.011],0.5,[0.011],FloquetColourCode
100,0,100,200,200[0.012],0.5,[0.012],FloquetColourCode
100,1,99,200,200[0.012],0.5,[0.012],FloquetColourCode
200,1,199,200,200[0.012],0.5,[0.012],FloquetColourCode
200,0,200,200,200[0.012],0.5,[0.012],FloquetColourCode
90,0,90,200,200[0.012],0.5,[0.012],FloquetColourCode
200,0,200,200,200[0.012],0.5,[0.012],FloquetColourCode
400,0,400,200,200[0.012],0.5,[0.012],FloquetColourCode
100,0,100,200,200[0.013],0.5,[0.013],FloquetColourCode
100,0,100,200,200[0.013],0.5,[0.013],FloquetColourCode
200,0,200,200,200[0.013],0.5,[0.013],FloquetColourCode
200,0,200,200,200[0.013],0.5,[0.013],FloquetColourCode
132,0,132,200,200[0.013],0.5,[0.013],FloquetColourCode
228,0,228,200,200[0.013],0.5,[0.013],FloquetColourCode
100,0,100,200,200[0.014],0.5,[0.014],FloquetColourCode
172,0,172,200,200[0.014],0.5,[0.014],FloquetColourCode
200,0,200,200,200[0.014],0.5,[0.014],FloquetColourCode
68,0,68,200,200[0.014],0.5,[0.014],FloquetColourCode
46,0,46,200,200[0.014],0.5,[0.014],FloquetColourCode
31,0,31,200,200[0.014],0.5,[0.014],FloquetColourCode
54,0,54,200,200[0.014],0.5,[0.014],FloquetColourCode
21,0,21,200,200[0.014],0.5,[0.014],FloquetColourCode
100,13,87,10,10[0.006],9999,[0.006],FloquetColourCode
100,10,90,10,10[0.006],9999,[0.006],FloquetColourCode
200,26,174,10,10[0.006],9999,[0.006],FloquetColourCode
200,17,183,10,10[0.006],9999,[0.006],FloquetColourCode
200,18,182,10,10[0.006],9999,[0.006],FloquetColourCode
400,47,353,10,10[0.006],9999,[0.006],FloquetColourCode
400,40,360,10,10[0.006],9999,[0.006],FloquetColourCode
800,85,715,10,10[0.006],9999,[0.006],FloquetColourCode
400,45,355,10,10[0.006],9999,[0.006],FloquetColourCode
1200,124,1076,10,10[0.006],9999,[0.006],FloquetColourCode
1200,131,1069,10,10[0.006],9999,[0.006],FloquetColourCode
