shots,bp_converged,postprocessing_count,max_bp_iters,id,bias,per,code_name
100,10,90,10,10[0.006],9999,[0.006],FloquetColourCode
100,10,90,10,10[0.006],9999,[0.006],FloquetColourCode
200,19,181,10,10[0.006],9999,[0.006],FloquetColourCode
200,15,185,10,10[0.006],9999,[0.006],FloquetColourCode
200,21,179,10,10[0.006],9999,[0.006],FloquetColourCode
400,50,350,10,10[0.006],9999,[0.006],FloquetColourCode
400,43,357,10,10[0.006],9999,[0.006],FloquetColourCode
800,88,712,10,10[0.006],9999,[0.006],FloquetColourCode
1200,105,1095,10,10[0.006],9999,[0.006],FloquetColourCode
400,40,360,10,10[0.006],9999,[0.006],FloquetColourCode
208,35,173,10,10[0.006],9999,[0.006],FloquetColourCode
4592,487,4105,10,10[0.006],9999,[0.006],FloquetColourCode
100,6,94,10,10[0.007],9999,[0.007],FloquetColourCode
100,5,95,10,10[0.007],9999,[0.007],FloquetColourCode
200,12,188,10,10[0.007],9999,[0.007],FloquetColourCode
200,7,193,10,10[0.007],9999,[0.007],FloquetColourCode
200,12,188,10,10[0.007],9999,[0.007],FloquetColourCode
400,21,379,10,10[0.007],9999,[0.007],FloquetColourCode
400,16,384,10,10[0.007],9999,[0.007],FloquetColourCode
800,42,758,10,10[0.007],9999,[0.007],FloquetColourCode
1200,43,1157,10,10[0.007],9999,[0.007],FloquetColourCode
1200,61,1139,10,10[0.007],9999,[0.007],FloquetColourCode
400,20,380,10,10[0.007],9999,[0.007],FloquetColourCode
2400,130,2270,10,10[0.007],9999,[0.007],FloquetColourCode
2400,105,2295,10,10[0.007],9999,[0.007],FloquetColourCode
100,3,97,10,10[0.008],9999,[0.008],FloquetColourCode
100,3,97,10,10[0.008],9999,[0.008],FloquetColourCode
200,4,196,10,10[0.008],9999,[0.008],FloquetColourCode
200,7,193,10,10[0.008],9999,[0.008],FloquetColourCode
200,2,198,10,10[0.008],9999,[0.008],FloquetColourCode
400,13,387,10,10[0.008],9999,[0.008],FloquetColourCode
400,14,386,10,10[0.008],9999,[0.008],FloquetColourCode
360,15,345,10,10[0.008],9999,[0.008],FloquetColourCode
800,16,784,10,10[0.008],9999,[0.008],FloquetColourCode
1200,30,1170,10,10[0.008],9999,[0.008],FloquetColourCode
1200,19,1181,10,10[0.008],9999,[0.008],FloquetColourCode
1710,34,1676,10,10[0.008],9999,[0.008],FloquetColourCode
100,0,100,10,10[0.009],9999,[0.009],FloquetColourCode
100,1,99,10,10[0.009],9999,[0.009],FloquetColourCode
200,4,196,10,10[0.009],9999,[0.009],FloquetColourCode
200,1,199,10,10[0.009],9999,[0.009],FloquetColourCode
200,0,200,10,10[0.009],9999,[0.009],FloquetColourCode
179,1,178,10,10[0.009],9999,[0.009],FloquetColourCode
400,4,396,10,10[0.009],9999,[0.009],FloquetColourCode
77,0,77,10,10[0.009],9999,[0.009],FloquetColourCode
400,4,396,10,10[0.009],9999,[0.009],FloquetColourCode
77,1,76,10,10[0.009],9999,[0.009],FloquetColourCode
46,2,44,10,10[0.009],9999,[0.009],FloquetColourCode
124,2,122,10,10[0.009],9999,[0.009],FloquetColourCode
209,3,206,10,10[0.009],9999,[0.009],FloquetColourCode
800,4,796,10,10[0.009],9999,[0.009],FloquetColourCode
100,1,99,10,10[0.01],9999,[0.01],FloquetColourCode
100,0,100,10,10[0.01],9999,[0.01],FloquetColourCode
200,1,199,10,10[0.01],9999,[0.01],FloquetColourCode
200,0,200,10,10[0.01],9999,[0.01],FloquetColourCode
65,0,65,10,10[0.01],9999,[0.01],FloquetColourCode
200,1,199,10,10[0.01],9999,[0.01],FloquetColourCode
400,1,399,10,10[0.01],9999,[0.01],FloquetColourCode
800,2,798,10,10[0.01],9999,[0.01],FloquetColourCode
100,0,100,10,10[0.011],9999,[0.011],FloquetColourCode
100,0,100,10,10[0.011],9999,[0.011],FloquetColourCode
200,0,200,10,10[0.011],9999,[0.011],FloquetColourCode
200,0,200,10,10[0.011],9999,[0.011],FloquetColourCode
385,0,385,10,10[0.011],9999,[0.011],FloquetColourCode
100,0,100,10,10[0.012],9999,[0.012],FloquetColourCode
100,0,100,10,10[0.012],9999,[0.012],FloquetColourCode
200,0,200,10,10[0.012],9999,[0.012],FloquetColourCode
200,0,200,10,10[0.012],9999,[0.012],FloquetColourCode
166,1,165,10,10[0.012],9999,[0.012],FloquetColourCode
100,0,100,10,10[0.013],9999,[0.013],FloquetColourCode
100,0,100,10,10[0.013],9999,[0.013],FloquetColourCode
200,0,200,10,10[0.013],9999,[0.013],FloquetColourCode
90,0,90,10,10[0.013],9999,[0.013],FloquetColourCode
200,0,200,10,10[0.013],9999,[0.013],FloquetColourCode
100,0,100,10,10[0.014],9999,[0.014],FloquetColourCode
77,0,77,10,10[0.014],9999,[0.014],FloquetColourCode
200,0,200,10,10[0.014],9999,[0.014],FloquetColourCode
200,0,200,10,10[0.014],9999,[0.014],FloquetColourCode
100,26,74,20,20[0.006],9999,[0.006],FloquetColourCode
100,18,82,20,20[0.006],9999,[0.006],FloquetColourCode
200,46,154,20,20[0.006],9999,[0.006],FloquetColourCode
200,41,159,20,20[0.006],9999,[0.006],FloquetColourCode
200,45,155,20,20[0.006],9999,[0.006],FloquetColourCode
400,99,301,20,20[0.006],9999,[0.006],FloquetColourCode
400,96,304,20,20[0.006],9999,[0.006],FloquetColourCode
800,181,619,20,20[0.006],9999,[0.006],FloquetColourCode
400,98,302,20,20[0.006],9999,[0.006],FloquetColourCode
1200,254,946,20,20[0.006],9999,[0.006],FloquetColourCode
1200,273,927,20,20[0.006],9999,[0.006],FloquetColourCode
2400,554,1846,20,20[0.006],9999,[0.006],FloquetColourCode
2400,543,1857,20,20[0.006],9999,[0.006],FloquetColourCode
100,20,80,20,20[0.007],9999,[0.007],FloquetColourCode
100,16,84,20,20[0.007],9999,[0.007],FloquetColourCode
200,25,175,20,20[0.007],9999,[0.007],FloquetColourCode
200,26,174,20,20[0.007],9999,[0.007],FloquetColourCode
200,28,172,20,20[0.007],9999,[0.007],FloquetColourCode
400,63,337,20,20[0.007],9999,[0.007],FloquetColourCode
400,58,342,20,20[0.007],9999,[0.007],FloquetColourCode
800,107,693,20,20[0.007],9999,[0.007],FloquetColourCode
1200,144,1056,20,20[0.007],9999,[0.007],FloquetColourCode
400,54,346,20,20[0.007],9999,[0.007],FloquetColourCode
1200,175,1025,20,20[0.007],9999,[0.007],FloquetColourCode
2400,339,2061,20,20[0.007],9999,[0.007],FloquetColourCode
2400,320,2080,20,20[0.007],9999,[0.007],FloquetColourCode
100,5,95,20,20[0.008],9999,[0.008],FloquetColourCode
100,5,95,20,20[0.008],9999,[0.008],FloquetColourCode
200,13,187,20,20[0.008],9999,[0.008],FloquetColourCode
200,14,186,20,20[0.008],9999,[0.008],FloquetColourCode
200,16,184,20,20[0.008],9999,[0.008],FloquetColourCode
400,23,377,20,20[0.008],9999,[0.008],FloquetColourCode
400,31,369,20,20[0.008],9999,[0.008],FloquetColourCode
800,63,737,20,20[0.008],9999,[0.008],FloquetColourCode
104,8,96,20,20[0.008],9999,[0.008],FloquetColourCode
1200,93,1107,20,20[0.008],9999,[0.008],FloquetColourCode
659,41,618,20,20[0.008],9999,[0.008],FloquetColourCode
315,21,294,20,20[0.008],9999,[0.008],FloquetColourCode
1200,95,1105,20,20[0.008],9999,[0.008],FloquetColourCode
1710,141,1569,20,20[0.008],9999,[0.008],FloquetColourCode
100,4,96,20,20[0.009],9999,[0.009],FloquetColourCode
100,3,97,20,20[0.009],9999,[0.009],FloquetColourCode
200,8,192,20,20[0.009],9999,[0.009],FloquetColourCode
200,6,194,20,20[0.009],9999,[0.009],FloquetColourCode
200,5,195,20,20[0.009],9999,[0.009],FloquetColourCode
400,14,386,20,20[0.009],9999,[0.009],FloquetColourCode
400,21,379,20,20[0.009],9999,[0.009],FloquetColourCode
353,17,336,20,20[0.009],9999,[0.009],FloquetColourCode
54,0,54,20,20[0.009],9999,[0.009],FloquetColourCode
36,0,36,20,20[0.009],9999,[0.009],FloquetColourCode
5,0,5,20,20[0.009],9999,[0.009],FloquetColourCode
547,17,530,20,20[0.009],9999,[0.009],FloquetColourCode
170,7,163,20,20[0.009],9999,[0.009],FloquetColourCode
800,35,765,20,20[0.009],9999,[0.009],FloquetColourCode
100,1,99,20,20[0.01],9999,[0.01],FloquetColourCode
100,2,98,20,20[0.01],9999,[0.01],FloquetColourCode
200,2,198,20,20[0.01],9999,[0.01],FloquetColourCode
200,4,196,20,20[0.01],9999,[0.01],FloquetColourCode
48,2,46,20,20[0.01],9999,[0.01],FloquetColourCode
200,5,195,20,20[0.01],9999,[0.01],FloquetColourCode
400,7,393,20,20[0.01],9999,[0.01],FloquetColourCode
133,1,132,20,20[0.01],9999,[0.01],FloquetColourCode
520,5,515,20,20[0.01],9999,[0.01],FloquetColourCode
100,1,99,20,20[0.011],9999,[0.011],FloquetColourCode
100,1,99,20,20[0.011],9999,[0.011],FloquetColourCode
200,4,196,20,20[0.011],9999,[0.011],FloquetColourCode
14,1,13,20,20[0.011],9999,[0.011],FloquetColourCode
7,0,7,20,20[0.011],9999,[0.011],FloquetColourCode
200,1,199,20,20[0.011],9999,[0.011],FloquetColourCode
200,1,199,20,20[0.011],9999,[0.011],FloquetColourCode
400,0,400,20,20[0.011],9999,[0.011],FloquetColourCode
100,0,100,20,20[0.012],9999,[0.012],FloquetColourCode
100,0,100,20,20[0.012],9999,[0.012],FloquetColourCode
200,2,198,20,20[0.012],9999,[0.012],FloquetColourCode
200,0,200,20,20[0.012],9999,[0.012],FloquetColourCode
28,0,28,20,20[0.012],9999,[0.012],FloquetColourCode
20,0,20,20,20[0.012],9999,[0.012],FloquetColourCode
166,1,165,20,20[0.012],9999,[0.012],FloquetColourCode
100,0,100,20,20[0.013],9999,[0.013],FloquetColourCode
71,0,71,20,20[0.013],9999,[0.013],FloquetColourCode
50,0,50,20,20[0.013],9999,[0.013],FloquetColourCode
2,0,2,20,20[0.013],9999,[0.013],FloquetColourCode
200,0,200,20,20[0.013],9999,[0.013],FloquetColourCode
51,0,51,20,20[0.013],9999,[0.013],FloquetColourCode
30,0,30,20,20[0.013],9999,[0.013],FloquetColourCode
100,0,100,20,20[0.014],9999,[0.014],FloquetColourCode
200,0,200,20,20[0.014],9999,[0.014],FloquetColourCode
195,0,195,20,20[0.014],9999,[0.014],FloquetColourCode
100,40,60,50,50[0.006],9999,[0.006],FloquetColourCode
100,36,64,50,50[0.006],9999,[0.006],FloquetColourCode
200,70,130,50,50[0.006],9999,[0.006],FloquetColourCode
200,63,137,50,50[0.006],9999,[0.006],FloquetColourCode
200,58,142,50,50[0.006],9999,[0.006],FloquetColourCode
400,122,278,50,50[0.006],9999,[0.006],FloquetColourCode
400,120,280,50,50[0.006],9999,[0.006],FloquetColourCode
800,233,567,50,50[0.006],9999,[0.006],FloquetColourCode
746,238,508,50,50[0.006],9999,[0.006],FloquetColourCode
1200,371,829,50,50[0.006],9999,[0.006],FloquetColourCode
882,266,616,50,50[0.006],9999,[0.006],FloquetColourCode
400,115,285,50,50[0.006],9999,[0.006],FloquetColourCode
1200,354,846,50,50[0.006],9999,[0.006],FloquetColourCode
1518,461,1057,50,50[0.006],9999,[0.006],FloquetColourCode
1654,535,1119,50,50[0.006],9999,[0.006],FloquetColourCode
100,22,78,50,50[0.007],9999,[0.007],FloquetColourCode
100,21,79,50,50[0.007],9999,[0.007],FloquetColourCode
200,43,157,50,50[0.007],9999,[0.007],FloquetColourCode
200,36,164,50,50[0.007],9999,[0.007],FloquetColourCode
200,39,161,50,50[0.007],9999,[0.007],FloquetColourCode
400,92,308,50,50[0.007],9999,[0.007],FloquetColourCode
400,79,321,50,50[0.007],9999,[0.007],FloquetColourCode
800,138,662,50,50[0.007],9999,[0.007],FloquetColourCode
292,61,231,50,50[0.007],9999,[0.007],FloquetColourCode
1200,244,956,50,50[0.007],9999,[0.007],FloquetColourCode
108,18,90,50,50[0.007],9999,[0.007],FloquetColourCode
985,178,807,50,50[0.007],9999,[0.007],FloquetColourCode
1200,247,953,50,50[0.007],9999,[0.007],FloquetColourCode
1032,187,845,50,50[0.007],9999,[0.007],FloquetColourCode
1368,264,1104,50,50[0.007],9999,[0.007],FloquetColourCode
1415,290,1125,50,50[0.007],9999,[0.007],FloquetColourCode
100,16,84,50,50[0.008],9999,[0.008],FloquetColourCode
100,12,88,50,50[0.008],9999,[0.008],FloquetColourCode
200,34,166,50,50[0.008],9999,[0.008],FloquetColourCode
200,19,181,50,50[0.008],9999,[0.008],FloquetColourCode
200,28,172,50,50[0.008],9999,[0.008],FloquetColourCode
400,44,356,50,50[0.008],9999,[0.008],FloquetColourCode
400,59,341,50,50[0.008],9999,[0.008],FloquetColourCode
93,10,83,50,50[0.008],9999,[0.008],FloquetColourCode
800,91,709,50,50[0.008],9999,[0.008],FloquetColourCode
1200,140,1060,50,50[0.008],9999,[0.008],FloquetColourCode
1200,140,1060,50,50[0.008],9999,[0.008],FloquetColourCode
984,123,861,50,50[0.008],9999,[0.008],FloquetColourCode
1292,155,1137,50,50[0.008],9999,[0.008],FloquetColourCode
586,69,517,50,50[0.008],9999,[0.008],FloquetColourCode
100,5,95,50,50[0.009],9999,[0.009],FloquetColourCode
100,4,96,50,50[0.009],9999,[0.009],FloquetColourCode
200,14,186,50,50[0.009],9999,[0.009],FloquetColourCode
200,11,189,50,50[0.009],9999,[0.009],FloquetColourCode
200,18,182,50,50[0.009],9999,[0.009],FloquetColourCode
400,19,381,50,50[0.009],9999,[0.009],FloquetColourCode
400,28,372,50,50[0.009],9999,[0.009],FloquetColourCode
329,24,305,50,50[0.009],9999,[0.009],FloquetColourCode
800,58,742,50,50[0.009],9999,[0.009],FloquetColourCode
858,51,807,50,50[0.009],9999,[0.009],FloquetColourCode
100,2,98,50,50[0.01],9999,[0.01],FloquetColourCode
100,5,95,50,50[0.01],9999,[0.01],FloquetColourCode
200,4,196,50,50[0.01],9999,[0.01],FloquetColourCode
200,7,193,50,50[0.01],9999,[0.01],FloquetColourCode
200,5,195,50,50[0.01],9999,[0.01],FloquetColourCode
173,5,168,50,50[0.01],9999,[0.01],FloquetColourCode
400,15,385,50,50[0.01],9999,[0.01],FloquetColourCode
800,31,769,50,50[0.01],9999,[0.01],FloquetColourCode
100,2,98,50,50[0.011],9999,[0.011],FloquetColourCode
100,5,95,50,50[0.011],9999,[0.011],FloquetColourCode
200,4,196,50,50[0.011],9999,[0.011],FloquetColourCode
200,8,192,50,50[0.011],9999,[0.011],FloquetColourCode
200,6,194,50,50[0.011],9999,[0.011],FloquetColourCode
400,5,395,50,50[0.011],9999,[0.011],FloquetColourCode
100,1,99,50,50[0.012],9999,[0.012],FloquetColourCode
100,0,100,50,50[0.012],9999,[0.012],FloquetColourCode
200,1,199,50,50[0.012],9999,[0.012],FloquetColourCode
89,2,87,50,50[0.012],9999,[0.012],FloquetColourCode
200,3,197,50,50[0.012],9999,[0.012],FloquetColourCode
400,1,399,50,50[0.012],9999,[0.012],FloquetColourCode
100,0,100,50,50[0.013],9999,[0.013],FloquetColourCode
100,0,100,50,50[0.013],9999,[0.013],FloquetColourCode
200,0,200,50,50[0.013],9999,[0.013],FloquetColourCode
200,0,200,50,50[0.013],9999,[0.013],FloquetColourCode
262,0,262,50,50[0.013],9999,[0.013],FloquetColourCode
100,0,100,50,50[0.014],9999,[0.014],FloquetColourCode
100,0,100,50,50[0.014],9999,[0.014],FloquetColourCode
200,1,199,50,50[0.014],9999,[0.014],FloquetColourCode
30,0,30,50,50[0.014],9999,[0.014],FloquetColourCode
100,29,71,200,200[0.006],9999,[0.006],FloquetColourCode
100,33,67,200,200[0.006],9999,[0.006],FloquetColourCode
200,68,132,200,200[0.006],9999,[0.006],FloquetColourCode
200,77,123,200,200[0.006],9999,[0.006],FloquetColourCode
200,75,125,200,200[0.006],9999,[0.006],FloquetColourCode
40,13,27,200,200[0.006],9999,[0.006],FloquetColourCode
400,143,257,200,200[0.006],9999,[0.006],FloquetColourCode
240,81,159,200,200[0.006],9999,[0.006],FloquetColourCode
480,181,299,200,200[0.006],9999,[0.006],FloquetColourCode
658,257,401,200,200[0.006],9999,[0.006],FloquetColourCode
542,196,346,200,200[0.006],9999,[0.006],FloquetColourCode
580,200,380,200,200[0.006],9999,[0.006],FloquetColourCode
580,192,388,200,200[0.006],9999,[0.006],FloquetColourCode
720,259,461,200,200[0.006],9999,[0.006],FloquetColourCode
410,134,276,200,200[0.006],9999,[0.006],FloquetColourCode
410,132,278,200,200[0.006],9999,[0.006],FloquetColourCode
355,119,236,200,200[0.006],9999,[0.006],FloquetColourCode
410,135,275,200,200[0.006],9999,[0.006],FloquetColourCode
304,110,194,200,200[0.006],9999,[0.006],FloquetColourCode
256,106,150,200,200[0.006],9999,[0.006],FloquetColourCode
279,96,183,200,200[0.006],9999,[0.006],FloquetColourCode
242,94,148,200,200[0.006],9999,[0.006],FloquetColourCode
216,73,143,200,200[0.006],9999,[0.006],FloquetColourCode
220,76,144,200,200[0.006],9999,[0.006],FloquetColourCode
231,69,162,200,200[0.006],9999,[0.006],FloquetColourCode
209,69,140,200,200[0.006],9999,[0.006],FloquetColourCode
225,63,162,200,200[0.006],9999,[0.006],FloquetColourCode
213,52,161,200,200[0.006],9999,[0.006],FloquetColourCode
207,70,137,200,200[0.006],9999,[0.006],FloquetColourCode
204,76,128,200,200[0.006],9999,[0.006],FloquetColourCode
203,81,122,200,200[0.006],9999,[0.006],FloquetColourCode
206,67,139,200,200[0.006],9999,[0.006],FloquetColourCode
160,55,105,200,200[0.006],9999,[0.006],FloquetColourCode
100,25,75,200,200[0.007],9999,[0.007],FloquetColourCode
100,25,75,200,200[0.007],9999,[0.007],FloquetColourCode
200,39,161,200,200[0.007],9999,[0.007],FloquetColourCode
200,53,147,200,200[0.007],9999,[0.007],FloquetColourCode
46,14,32,200,200[0.007],9999,[0.007],FloquetColourCode
200,56,144,200,200[0.007],9999,[0.007],FloquetColourCode
232,56,176,200,200[0.007],9999,[0.007],FloquetColourCode
276,60,216,200,200[0.007],9999,[0.007],FloquetColourCode
400,88,312,200,200[0.007],9999,[0.007],FloquetColourCode
563,136,427,200,200[0.007],9999,[0.007],FloquetColourCode
484,123,361,200,200[0.007],9999,[0.007],FloquetColourCode
484,126,358,200,200[0.007],9999,[0.007],FloquetColourCode
577,157,420,200,200[0.007],9999,[0.007],FloquetColourCode
577,139,438,200,200[0.007],9999,[0.007],FloquetColourCode
280,76,204,200,200[0.007],9999,[0.007],FloquetColourCode
251,52,199,200,200[0.007],9999,[0.007],FloquetColourCode
637,147,490,200,200[0.007],9999,[0.007],FloquetColourCode
344,82,262,200,200[0.007],9999,[0.007],FloquetColourCode
344,82,262,200,200[0.007],9999,[0.007],FloquetColourCode
237,50,187,200,200[0.007],9999,[0.007],FloquetColourCode
212,57,155,200,200[0.007],9999,[0.007],FloquetColourCode
219,54,165,200,200[0.007],9999,[0.007],FloquetColourCode
215,60,155,200,200[0.007],9999,[0.007],FloquetColourCode
214,57,157,200,200[0.007],9999,[0.007],FloquetColourCode
227,51,176,200,200[0.007],9999,[0.007],FloquetColourCode
214,49,165,200,200[0.007],9999,[0.007],FloquetColourCode
212,52,160,200,200[0.007],9999,[0.007],FloquetColourCode
212,65,147,200,200[0.007],9999,[0.007],FloquetColourCode
213,48,165,200,200[0.007],9999,[0.007],FloquetColourCode
215,53,162,200,200[0.007],9999,[0.007],FloquetColourCode
219,47,172,200,200[0.007],9999,[0.007],FloquetColourCode
222,62,160,200,200[0.007],9999,[0.007],FloquetColourCode
217,52,165,200,200[0.007],9999,[0.007],FloquetColourCode
220,65,155,200,200[0.007],9999,[0.007],FloquetColourCode
223,59,164,200,200[0.007],9999,[0.007],FloquetColourCode
214,46,168,200,200[0.007],9999,[0.007],FloquetColourCode
100,10,90,200,200[0.008],9999,[0.008],FloquetColourCode
100,16,84,200,200[0.008],9999,[0.008],FloquetColourCode
200,32,168,200,200[0.008],9999,[0.008],FloquetColourCode
200,30,170,200,200[0.008],9999,[0.008],FloquetColourCode
200,34,166,200,200[0.008],9999,[0.008],FloquetColourCode
400,53,347,200,200[0.008],9999,[0.008],FloquetColourCode
400,53,347,200,200[0.008],9999,[0.008],FloquetColourCode
434,57,377,200,200[0.008],9999,[0.008],FloquetColourCode
448,75,373,200,200[0.008],9999,[0.008],FloquetColourCode
357,59,298,200,200[0.008],9999,[0.008],FloquetColourCode
766,127,639,200,200[0.008],9999,[0.008],FloquetColourCode
681,109,572,200,200[0.008],9999,[0.008],FloquetColourCode
800,108,692,200,200[0.008],9999,[0.008],FloquetColourCode
662,116,546,200,200[0.008],9999,[0.008],FloquetColourCode
752,120,632,200,200[0.008],9999,[0.008],FloquetColourCode
522,64,458,200,200[0.008],9999,[0.008],FloquetColourCode
681,83,598,200,200[0.008],9999,[0.008],FloquetColourCode
681,99,582,200,200[0.008],9999,[0.008],FloquetColourCode
100,12,88,200,200[0.009],9999,[0.009],FloquetColourCode
100,10,90,200,200[0.009],9999,[0.009],FloquetColourCode
200,22,178,200,200[0.009],9999,[0.009],FloquetColourCode
200,18,182,200,200[0.009],9999,[0.009],FloquetColourCode
200,11,189,200,200[0.009],9999,[0.009],FloquetColourCode
402,46,356,200,200[0.009],9999,[0.009],FloquetColourCode
5,1,4,200,200[0.009],9999,[0.009],FloquetColourCode
17,2,15,200,200[0.009],9999,[0.009],FloquetColourCode
400,40,360,200,200[0.009],9999,[0.009],FloquetColourCode
400,36,364,200,200[0.009],9999,[0.009],FloquetColourCode
525,53,472,200,200[0.009],9999,[0.009],FloquetColourCode
800,72,728,200,200[0.009],9999,[0.009],FloquetColourCode
798,58,740,200,200[0.009],9999,[0.009],FloquetColourCode
100,9,91,200,200[0.01],9999,[0.01],FloquetColourCode
100,7,93,200,200[0.01],9999,[0.01],FloquetColourCode
200,12,188,200,200[0.01],9999,[0.01],FloquetColourCode
200,10,190,200,200[0.01],9999,[0.01],FloquetColourCode
65,2,63,200,200[0.01],9999,[0.01],FloquetColourCode
200,9,191,200,200[0.01],9999,[0.01],FloquetColourCode
227,10,217,200,200[0.01],9999,[0.01],FloquetColourCode
185,11,174,200,200[0.01],9999,[0.01],FloquetColourCode
54,0,54,200,200[0.01],9999,[0.01],FloquetColourCode
400,19,381,200,200[0.01],9999,[0.01],FloquetColourCode
92,6,86,200,200[0.01],9999,[0.01],FloquetColourCode
800,41,759,200,200[0.01],9999,[0.01],FloquetColourCode
100,4,96,200,200[0.011],9999,[0.011],FloquetColourCode
100,4,96,200,200[0.011],9999,[0.011],FloquetColourCode
200,5,195,200,200[0.011],9999,[0.011],FloquetColourCode
200,8,192,200,200[0.011],9999,[0.011],FloquetColourCode
300,11,289,200,200[0.011],9999,[0.011],FloquetColourCode
280,8,272,200,200[0.011],9999,[0.011],FloquetColourCode
100,1,99,200,200[0.012],9999,[0.012],FloquetColourCode
100,2,98,200,200[0.012],9999,[0.012],FloquetColourCode
200,2,198,200,200[0.012],9999,[0.012],FloquetColourCode
200,1,199,200,200[0.012],9999,[0.012],FloquetColourCode
28,0,28,200,200[0.012],9999,[0.012],FloquetColourCode
166,1,165,200,200[0.012],9999,[0.012],FloquetColourCode
100,1,99,200,200[0.013],9999,[0.013],FloquetColourCode
100,2,98,200,200[0.013],9999,[0.013],FloquetColourCode
46,0,46,200,200[0.013],9999,[0.013],FloquetColourCode
41,0,41,200,200[0.013],9999,[0.013],FloquetColourCode
200,1,199,200,200[0.013],9999,[0.013],FloquetColourCode
200,0,200,200,200[0.013],9999,[0.013],FloquetColourCode
31,0,31,200,200[0.013],9999,[0.013],FloquetColourCode
100,0,100,200,200[0.014],9999,[0.014],FloquetColourCode
133,1,132,200,200[0.014],9999,[0.014],FloquetColourCode
200,1,199,200,200[0.014],9999,[0.014],FloquetColourCode
13,0,13,200,200[0.014],9999,[0.014],FloquetColourCode
100,41,59,500,500[0.006],9999,[0.006],FloquetColourCode
100,42,58,500,500[0.006],9999,[0.006],FloquetColourCode
200,64,136,500,500[0.006],9999,[0.006],FloquetColourCode
200,70,130,500,500[0.006],9999,[0.006],FloquetColourCode
200,72,128,500,500[0.006],9999,[0.006],FloquetColourCode
16,3,13,500,500[0.006],9999,[0.006],FloquetColourCode
96,35,61,500,500[0.006],9999,[0.006],FloquetColourCode
1,0,1,500,500[0.006],9999,[0.006],FloquetColourCode
6,1,5,500,500[0.006],9999,[0.006],FloquetColourCode
36,15,21,500,500[0.006],9999,[0.006],FloquetColourCode
423,156,267,500,500[0.006],9999,[0.006],FloquetColourCode
400,143,257,500,500[0.006],9999,[0.006],FloquetColourCode
216,85,131,500,500[0.006],9999,[0.006],FloquetColourCode
538,197,341,500,500[0.006],9999,[0.006],FloquetColourCode
508,201,307,500,500[0.006],9999,[0.006],FloquetColourCode
436,176,260,500,500[0.006],9999,[0.006],FloquetColourCode
508,187,321,500,500[0.006],9999,[0.006],FloquetColourCode
592,221,371,500,500[0.006],9999,[0.006],FloquetColourCode
575,217,358,500,500[0.006],9999,[0.006],FloquetColourCode
662,245,417,500,500[0.006],9999,[0.006],FloquetColourCode
592,205,387,500,500[0.006],9999,[0.006],FloquetColourCode
777,276,501,500,500[0.006],9999,[0.006],FloquetColourCode
350,119,231,500,500[0.006],9999,[0.006],FloquetColourCode
278,101,177,500,500[0.006],9999,[0.006],FloquetColourCode
196,80,116,500,500[0.006],9999,[0.006],FloquetColourCode
169,65,104,500,500[0.006],9999,[0.006],FloquetColourCode
210,88,122,500,500[0.006],9999,[0.006],FloquetColourCode
235,85,150,500,500[0.006],9999,[0.006],FloquetColourCode
175,63,112,500,500[0.006],9999,[0.006],FloquetColourCode
183,59,124,500,500[0.006],9999,[0.006],FloquetColourCode
163,58,105,500,500[0.006],9999,[0.006],FloquetColourCode
157,54,103,500,500[0.006],9999,[0.006],FloquetColourCode
161,50,111,500,500[0.006],9999,[0.006],FloquetColourCode
156,64,92,500,500[0.006],9999,[0.006],FloquetColourCode
75,31,44,500,500[0.006],9999,[0.006],FloquetColourCode
155,47,108,500,500[0.006],9999,[0.006],FloquetColourCode
155,63,92,500,500[0.006],9999,[0.006],FloquetColourCode
100,22,78,500,500[0.007],9999,[0.007],FloquetColourCode
100,24,76,500,500[0.007],9999,[0.007],FloquetColourCode
200,51,149,500,500[0.007],9999,[0.007],FloquetColourCode
200,35,165,500,500[0.007],9999,[0.007],FloquetColourCode
200,40,160,500,500[0.007],9999,[0.007],FloquetColourCode
87,28,59,500,500[0.007],9999,[0.007],FloquetColourCode
316,82,234,500,500[0.007],9999,[0.007],FloquetColourCode
400,110,290,500,500[0.007],9999,[0.007],FloquetColourCode
371,108,263,500,500[0.007],9999,[0.007],FloquetColourCode
442,127,315,500,500[0.007],9999,[0.007],FloquetColourCode
371,83,288,500,500[0.007],9999,[0.007],FloquetColourCode
280,85,195,500,500[0.007],9999,[0.007],FloquetColourCode
323,94,229,500,500[0.007],9999,[0.007],FloquetColourCode
323,92,231,500,500[0.007],9999,[0.007],FloquetColourCode
371,100,271,500,500[0.007],9999,[0.007],FloquetColourCode
442,110,332,500,500[0.007],9999,[0.007],FloquetColourCode
233,58,175,500,500[0.007],9999,[0.007],FloquetColourCode
194,48,146,500,500[0.007],9999,[0.007],FloquetColourCode
164,43,121,500,500[0.007],9999,[0.007],FloquetColourCode
155,38,117,500,500[0.007],9999,[0.007],FloquetColourCode
145,41,104,500,500[0.007],9999,[0.007],FloquetColourCode
138,39,99,500,500[0.007],9999,[0.007],FloquetColourCode
141,37,104,500,500[0.007],9999,[0.007],FloquetColourCode
150,37,113,500,500[0.007],9999,[0.007],FloquetColourCode
135,31,104,500,500[0.007],9999,[0.007],FloquetColourCode
173,42,131,500,500[0.007],9999,[0.007],FloquetColourCode
135,37,98,500,500[0.007],9999,[0.007],FloquetColourCode
132,33,99,500,500[0.007],9999,[0.007],FloquetColourCode
133,36,97,500,500[0.007],9999,[0.007],FloquetColourCode
134,29,105,500,500[0.007],9999,[0.007],FloquetColourCode
129,35,94,500,500[0.007],9999,[0.007],FloquetColourCode
129,41,88,500,500[0.007],9999,[0.007],FloquetColourCode
130,38,92,500,500[0.007],9999,[0.007],FloquetColourCode
128,38,90,500,500[0.007],9999,[0.007],FloquetColourCode
131,37,94,500,500[0.007],9999,[0.007],FloquetColourCode
131,26,105,500,500[0.007],9999,[0.007],FloquetColourCode
128,27,101,500,500[0.007],9999,[0.007],FloquetColourCode
127,36,91,500,500[0.007],9999,[0.007],FloquetColourCode
126,37,89,500,500[0.007],9999,[0.007],FloquetColourCode
124,39,85,500,500[0.007],9999,[0.007],FloquetColourCode
126,33,93,500,500[0.007],9999,[0.007],FloquetColourCode
125,31,94,500,500[0.007],9999,[0.007],FloquetColourCode
126,27,99,500,500[0.007],9999,[0.007],FloquetColourCode
126,27,99,500,500[0.007],9999,[0.007],FloquetColourCode
125,24,101,500,500[0.007],9999,[0.007],FloquetColourCode
127,18,109,500,500[0.007],9999,[0.007],FloquetColourCode
124,34,90,500,500[0.007],9999,[0.007],FloquetColourCode
44,11,33,500,500[0.007],9999,[0.007],FloquetColourCode
124,37,87,500,500[0.007],9999,[0.007],FloquetColourCode
124,26,98,500,500[0.007],9999,[0.007],FloquetColourCode
123,38,85,500,500[0.007],9999,[0.007],FloquetColourCode
121,23,98,500,500[0.007],9999,[0.007],FloquetColourCode
123,36,87,500,500[0.007],9999,[0.007],FloquetColourCode
124,28,96,500,500[0.007],9999,[0.007],FloquetColourCode
122,36,86,500,500[0.007],9999,[0.007],FloquetColourCode
122,21,101,500,500[0.007],9999,[0.007],FloquetColourCode
123,23,100,500,500[0.007],9999,[0.007],FloquetColourCode
100,13,87,500,500[0.008],9999,[0.008],FloquetColourCode
100,15,85,500,500[0.008],9999,[0.008],FloquetColourCode
200,38,162,500,500[0.008],9999,[0.008],FloquetColourCode
200,34,166,500,500[0.008],9999,[0.008],FloquetColourCode
200,33,167,500,500[0.008],9999,[0.008],FloquetColourCode
400,68,332,500,500[0.008],9999,[0.008],FloquetColourCode
153,21,132,500,500[0.008],9999,[0.008],FloquetColourCode
192,39,153,500,500[0.008],9999,[0.008],FloquetColourCode
317,52,265,500,500[0.008],9999,[0.008],FloquetColourCode
336,51,285,500,500[0.008],9999,[0.008],FloquetColourCode
336,52,284,500,500[0.008],9999,[0.008],FloquetColourCode
336,55,281,500,500[0.008],9999,[0.008],FloquetColourCode
349,55,294,500,500[0.008],9999,[0.008],FloquetColourCode
349,63,286,500,500[0.008],9999,[0.008],FloquetColourCode
255,47,208,500,500[0.008],9999,[0.008],FloquetColourCode
349,49,300,500,500[0.008],9999,[0.008],FloquetColourCode
192,29,163,500,500[0.008],9999,[0.008],FloquetColourCode
213,30,183,500,500[0.008],9999,[0.008],FloquetColourCode
125,19,106,500,500[0.008],9999,[0.008],FloquetColourCode
128,22,106,500,500[0.008],9999,[0.008],FloquetColourCode
121,22,99,500,500[0.008],9999,[0.008],FloquetColourCode
122,15,107,500,500[0.008],9999,[0.008],FloquetColourCode
124,20,104,500,500[0.008],9999,[0.008],FloquetColourCode
133,19,114,500,500[0.008],9999,[0.008],FloquetColourCode
140,18,122,500,500[0.008],9999,[0.008],FloquetColourCode
150,19,131,500,500[0.008],9999,[0.008],FloquetColourCode
164,30,134,500,500[0.008],9999,[0.008],FloquetColourCode
119,19,100,500,500[0.008],9999,[0.008],FloquetColourCode
119,18,101,500,500[0.008],9999,[0.008],FloquetColourCode
114,17,97,500,500[0.008],9999,[0.008],FloquetColourCode
118,20,98,500,500[0.008],9999,[0.008],FloquetColourCode
93,18,75,500,500[0.008],9999,[0.008],FloquetColourCode
118,16,102,500,500[0.008],9999,[0.008],FloquetColourCode
117,27,90,500,500[0.008],9999,[0.008],FloquetColourCode
115,19,96,500,500[0.008],9999,[0.008],FloquetColourCode
116,15,101,500,500[0.008],9999,[0.008],FloquetColourCode
115,12,103,500,500[0.008],9999,[0.008],FloquetColourCode
100,15,85,500,500[0.009],9999,[0.009],FloquetColourCode
100,12,88,500,500[0.009],9999,[0.009],FloquetColourCode
200,21,179,500,500[0.009],9999,[0.009],FloquetColourCode
200,15,185,500,500[0.009],9999,[0.009],FloquetColourCode
75,6,69,500,500[0.009],9999,[0.009],FloquetColourCode
200,21,179,500,500[0.009],9999,[0.009],FloquetColourCode
141,9,132,500,500[0.009],9999,[0.009],FloquetColourCode
400,42,358,500,500[0.009],9999,[0.009],FloquetColourCode
228,29,199,500,500[0.009],9999,[0.009],FloquetColourCode
353,38,315,500,500[0.009],9999,[0.009],FloquetColourCode
353,51,302,500,500[0.009],9999,[0.009],FloquetColourCode
272,25,247,500,500[0.009],9999,[0.009],FloquetColourCode
186,17,169,500,500[0.009],9999,[0.009],FloquetColourCode
375,34,341,500,500[0.009],9999,[0.009],FloquetColourCode
353,26,327,500,500[0.009],9999,[0.009],FloquetColourCode
375,36,339,500,500[0.009],9999,[0.009],FloquetColourCode
375,36,339,500,500[0.009],9999,[0.009],FloquetColourCode
48,4,44,500,500[0.009],9999,[0.009],FloquetColourCode
163,15,148,500,500[0.009],9999,[0.009],FloquetColourCode
138,10,128,500,500[0.009],9999,[0.009],FloquetColourCode
148,13,135,500,500[0.009],9999,[0.009],FloquetColourCode
129,17,112,500,500[0.009],9999,[0.009],FloquetColourCode
100,2,98,500,500[0.01],9999,[0.01],FloquetColourCode
100,7,93,500,500[0.01],9999,[0.01],FloquetColourCode
200,11,189,500,500[0.01],9999,[0.01],FloquetColourCode
200,13,187,500,500[0.01],9999,[0.01],FloquetColourCode
257,13,244,500,500[0.01],9999,[0.01],FloquetColourCode
351,21,330,500,500[0.01],9999,[0.01],FloquetColourCode
271,14,257,500,500[0.01],9999,[0.01],FloquetColourCode
343,24,319,500,500[0.01],9999,[0.01],FloquetColourCode
20,0,20,500,500[0.01],9999,[0.01],FloquetColourCode
351,20,331,500,500[0.01],9999,[0.01],FloquetColourCode
152,12,140,500,500[0.01],9999,[0.01],FloquetColourCode
100,1,99,500,500[0.011],9999,[0.011],FloquetColourCode
100,5,95,500,500[0.011],9999,[0.011],FloquetColourCode
200,6,194,500,500[0.011],9999,[0.011],FloquetColourCode
200,8,192,500,500[0.011],9999,[0.011],FloquetColourCode
145,6,139,500,500[0.011],9999,[0.011],FloquetColourCode
52,3,49,500,500[0.011],9999,[0.011],FloquetColourCode
7,2,5,500,500[0.011],9999,[0.011],FloquetColourCode
262,12,250,500,500[0.011],9999,[0.011],FloquetColourCode
11,0,11,500,500[0.011],9999,[0.011],FloquetColourCode
14,1,13,500,500[0.011],9999,[0.011],FloquetColourCode
160,8,152,500,500[0.011],9999,[0.011],FloquetColourCode
17,0,17,500,500[0.011],9999,[0.011],FloquetColourCode
4,0,4,500,500[0.011],9999,[0.011],FloquetColourCode
103,5,98,500,500[0.011],9999,[0.011],FloquetColourCode
100,4,96,500,500[0.012],9999,[0.012],FloquetColourCode
100,1,99,500,500[0.012],9999,[0.012],FloquetColourCode
200,2,198,500,500[0.012],9999,[0.012],FloquetColourCode
200,6,194,500,500[0.012],9999,[0.012],FloquetColourCode
96,0,96,500,500[0.012],9999,[0.012],FloquetColourCode
58,0,58,500,500[0.012],9999,[0.012],FloquetColourCode
393,7,386,500,500[0.012],9999,[0.012],FloquetColourCode
100,1,99,500,500[0.013],9999,[0.013],FloquetColourCode
195,0,195,500,500[0.013],9999,[0.013],FloquetColourCode
200,2,198,500,500[0.013],9999,[0.013],FloquetColourCode
80,0,80,500,500[0.013],9999,[0.013],FloquetColourCode
100,2,98,500,500[0.014],9999,[0.014],FloquetColourCode
58,0,58,500,500[0.014],9999,[0.014],FloquetColourCode
51,0,51,500,500[0.014],9999,[0.014],FloquetColourCode
23,0,23,500,500[0.014],9999,[0.014],FloquetColourCode
200,1,199,500,500[0.014],9999,[0.014],FloquetColourCode
32,0,32,500,500[0.014],9999,[0.014],FloquetColourCode
14,0,14,500,500[0.014],9999,[0.014],FloquetColourCode
