shots,bp_converged,postprocessing_count,max_bp_iters,id,bias,per,code_name
100,45,55,10,10[0.006],9999,[0.006],HoneycombCode
100,41,59,10,10[0.006],9999,[0.006],HoneycombCode
200,82,118,10,10[0.006],9999,[0.006],HoneycombCode
200,80,120,10,10[0.006],9999,[0.006],HoneycombCode
200,83,117,10,10[0.006],9999,[0.006],HoneycombCode
400,155,245,10,10[0.006],9999,[0.006],HoneycombCode
400,149,251,10,10[0.006],9999,[0.006],HoneycombCode
800,319,481,10,10[0.006],9999,[0.006],HoneycombCode
400,155,245,10,10[0.006],9999,[0.006],HoneycombCode
1200,500,700,10,10[0.006],9999,[0.006],HoneycombCode
1200,449,751,10,10[0.006],9999,[0.006],HoneycombCode
2400,963,1437,10,10[0.006],9999,[0.006],HoneycombCode
2400,937,1463,10,10[0.006],9999,[0.006],HoneycombCode
100,25,75,10,10[0.007],9999,[0.007],HoneycombCode
100,27,73,10,10[0.007],9999,[0.007],HoneycombCode
200,55,145,10,10[0.007],9999,[0.007],HoneycombCode
200,65,135,10,10[0.007],9999,[0.007],HoneycombCode
200,58,142,10,10[0.007],9999,[0.007],HoneycombCode
400,113,287,10,10[0.007],9999,[0.007],HoneycombCode
400,120,280,10,10[0.007],9999,[0.007],HoneycombCode
800,233,567,10,10[0.007],9999,[0.007],HoneycombCode
400,100,300,10,10[0.007],9999,[0.007],HoneycombCode
1200,362,838,10,10[0.007],9999,[0.007],HoneycombCode
1200,330,870,10,10[0.007],9999,[0.007],HoneycombCode
2400,707,1693,10,10[0.007],9999,[0.007],HoneycombCode
2400,690,1710,10,10[0.007],9999,[0.007],HoneycombCode
100,13,87,10,10[0.009],9999,[0.009],HoneycombCode
100,9,91,10,10[0.009],9999,[0.009],HoneycombCode
200,27,173,10,10[0.009],9999,[0.009],HoneycombCode
200,25,175,10,10[0.009],9999,[0.009],HoneycombCode
200,24,176,10,10[0.009],9999,[0.009],HoneycombCode
400,51,349,10,10[0.009],9999,[0.009],HoneycombCode
400,51,349,10,10[0.009],9999,[0.009],HoneycombCode
800,110,690,10,10[0.009],9999,[0.009],HoneycombCode
1200,141,1059,10,10[0.009],9999,[0.009],HoneycombCode
885,110,775,10,10[0.009],9999,[0.009],HoneycombCode
822,100,722,10,10[0.009],9999,[0.009],HoneycombCode
1200,148,1052,10,10[0.009],9999,[0.009],HoneycombCode
100,8,92,10,10[0.01],9999,[0.01],HoneycombCode
100,11,89,10,10[0.01],9999,[0.01],HoneycombCode
200,15,185,10,10[0.01],9999,[0.01],HoneycombCode
200,8,192,10,10[0.01],9999,[0.01],HoneycombCode
200,20,180,10,10[0.01],9999,[0.01],HoneycombCode
400,24,376,10,10[0.01],9999,[0.01],HoneycombCode
400,31,369,10,10[0.01],9999,[0.01],HoneycombCode
128,11,117,10,10[0.01],9999,[0.01],HoneycombCode
800,54,746,10,10[0.01],9999,[0.01],HoneycombCode
983,73,910,10,10[0.01],9999,[0.01],HoneycombCode
1200,94,1106,10,10[0.01],9999,[0.01],HoneycombCode
100,4,96,10,10[0.011],9999,[0.011],HoneycombCode
100,10,90,10,10[0.011],9999,[0.011],HoneycombCode
200,4,196,10,10[0.011],9999,[0.011],HoneycombCode
200,12,188,10,10[0.011],9999,[0.011],HoneycombCode
200,8,192,10,10[0.011],9999,[0.011],HoneycombCode
294,17,277,10,10[0.011],9999,[0.011],HoneycombCode
400,23,377,10,10[0.011],9999,[0.011],HoneycombCode
265,5,260,10,10[0.011],9999,[0.011],HoneycombCode
285,16,269,10,10[0.011],9999,[0.011],HoneycombCode
124,8,116,10,10[0.011],9999,[0.011],HoneycombCode
240,16,224,10,10[0.011],9999,[0.011],HoneycombCode
800,32,768,10,10[0.011],9999,[0.011],HoneycombCode
100,1,99,10,10[0.012],9999,[0.012],HoneycombCode
100,4,96,10,10[0.012],9999,[0.012],HoneycombCode
200,5,195,10,10[0.012],9999,[0.012],HoneycombCode
200,3,197,10,10[0.012],9999,[0.012],HoneycombCode
200,4,196,10,10[0.012],9999,[0.012],HoneycombCode
400,14,386,10,10[0.012],9999,[0.012],HoneycombCode
452,12,440,10,10[0.012],9999,[0.012],HoneycombCode
100,0,100,10,10[0.013],9999,[0.013],HoneycombCode
100,2,98,10,10[0.013],9999,[0.013],HoneycombCode
200,2,198,10,10[0.013],9999,[0.013],HoneycombCode
200,4,196,10,10[0.013],9999,[0.013],HoneycombCode
200,3,197,10,10[0.013],9999,[0.013],HoneycombCode
329,5,324,10,10[0.013],9999,[0.013],HoneycombCode
400,5,395,10,10[0.013],9999,[0.013],HoneycombCode
100,0,100,10,10[0.014],9999,[0.014],HoneycombCode
100,0,100,10,10[0.014],9999,[0.014],HoneycombCode
200,0,200,10,10[0.014],9999,[0.014],HoneycombCode
101,2,99,10,10[0.014],9999,[0.014],HoneycombCode
200,0,200,10,10[0.014],9999,[0.014],HoneycombCode
385,2,383,10,10[0.014],9999,[0.014],HoneycombCode
80,0,80,10,10[0.014],9999,[0.014],HoneycombCode
100,1,99,10,10[0.015],9999,[0.015],HoneycombCode
100,1,99,10,10[0.015],9999,[0.015],HoneycombCode
200,2,198,10,10[0.015],9999,[0.015],HoneycombCode
90,0,90,10,10[0.015],9999,[0.015],HoneycombCode
10,0,10,10,10[0.015],9999,[0.015],HoneycombCode
32,0,32,10,10[0.015],9999,[0.015],HoneycombCode
200,2,198,10,10[0.015],9999,[0.015],HoneycombCode
100,1,99,10,10[0.016],9999,[0.016],HoneycombCode
47,0,47,10,10[0.016],9999,[0.016],HoneycombCode
39,0,39,10,10[0.016],9999,[0.016],HoneycombCode
15,0,15,10,10[0.016],9999,[0.016],HoneycombCode
200,0,200,10,10[0.016],9999,[0.016],HoneycombCode
200,0,200,10,10[0.016],9999,[0.016],HoneycombCode
7,0,7,10,10[0.016],9999,[0.016],HoneycombCode
12,0,12,10,10[0.016],9999,[0.016],HoneycombCode
100,0,100,10,10[0.017],9999,[0.017],HoneycombCode
20,0,20,10,10[0.017],9999,[0.017],HoneycombCode
200,0,200,10,10[0.017],9999,[0.017],HoneycombCode
200,0,200,10,10[0.017],9999,[0.017],HoneycombCode
100,45,55,20,20[0.006],9999,[0.006],HoneycombCode
100,45,55,20,20[0.006],9999,[0.006],HoneycombCode
200,105,95,20,20[0.006],9999,[0.006],HoneycombCode
200,87,113,20,20[0.006],9999,[0.006],HoneycombCode
200,94,106,20,20[0.006],9999,[0.006],HoneycombCode
400,188,212,20,20[0.006],9999,[0.006],HoneycombCode
400,190,210,20,20[0.006],9999,[0.006],HoneycombCode
800,354,446,20,20[0.006],9999,[0.006],HoneycombCode
1200,499,701,20,20[0.006],9999,[0.006],HoneycombCode
400,192,208,20,20[0.006],9999,[0.006],HoneycombCode
1200,523,677,20,20[0.006],9999,[0.006],HoneycombCode
2400,1075,1325,20,20[0.006],9999,[0.006],HoneycombCode
2400,1061,1339,20,20[0.006],9999,[0.006],HoneycombCode
100,38,62,20,20[0.007],9999,[0.007],HoneycombCode
100,33,67,20,20[0.007],9999,[0.007],HoneycombCode
200,71,129,20,20[0.007],9999,[0.007],HoneycombCode
200,80,120,20,20[0.007],9999,[0.007],HoneycombCode
200,71,129,20,20[0.007],9999,[0.007],HoneycombCode
400,149,251,20,20[0.007],9999,[0.007],HoneycombCode
400,146,254,20,20[0.007],9999,[0.007],HoneycombCode
800,289,511,20,20[0.007],9999,[0.007],HoneycombCode
400,120,280,20,20[0.007],9999,[0.007],HoneycombCode
1200,416,784,20,20[0.007],9999,[0.007],HoneycombCode
1200,419,781,20,20[0.007],9999,[0.007],HoneycombCode
2400,813,1587,20,20[0.007],9999,[0.007],HoneycombCode
2400,849,1551,20,20[0.007],9999,[0.007],HoneycombCode
100,13,87,20,20[0.009],9999,[0.009],HoneycombCode
100,21,79,20,20[0.009],9999,[0.009],HoneycombCode
200,40,160,20,20[0.009],9999,[0.009],HoneycombCode
200,38,162,20,20[0.009],9999,[0.009],HoneycombCode
200,30,170,20,20[0.009],9999,[0.009],HoneycombCode
400,77,323,20,20[0.009],9999,[0.009],HoneycombCode
400,71,329,20,20[0.009],9999,[0.009],HoneycombCode
800,145,655,20,20[0.009],9999,[0.009],HoneycombCode
1200,203,997,20,20[0.009],9999,[0.009],HoneycombCode
1200,191,1009,20,20[0.009],9999,[0.009],HoneycombCode
1479,249,1230,20,20[0.009],9999,[0.009],HoneycombCode
2400,417,1983,20,20[0.009],9999,[0.009],HoneycombCode
100,15,85,20,20[0.01],9999,[0.01],HoneycombCode
100,7,93,20,20[0.01],9999,[0.01],HoneycombCode
200,18,182,20,20[0.01],9999,[0.01],HoneycombCode
200,20,180,20,20[0.01],9999,[0.01],HoneycombCode
200,19,181,20,20[0.01],9999,[0.01],HoneycombCode
400,49,351,20,20[0.01],9999,[0.01],HoneycombCode
400,48,352,20,20[0.01],9999,[0.01],HoneycombCode
800,95,705,20,20[0.01],9999,[0.01],HoneycombCode
1200,148,1052,20,20[0.01],9999,[0.01],HoneycombCode
100,9,91,20,20[0.011],9999,[0.011],HoneycombCode
100,1,99,20,20[0.011],9999,[0.011],HoneycombCode
200,13,187,20,20[0.011],9999,[0.011],HoneycombCode
200,22,178,20,20[0.011],9999,[0.011],HoneycombCode
200,17,183,20,20[0.011],9999,[0.011],HoneycombCode
400,26,374,20,20[0.011],9999,[0.011],HoneycombCode
400,38,362,20,20[0.011],9999,[0.011],HoneycombCode
25,2,23,20,20[0.011],9999,[0.011],HoneycombCode
800,63,737,20,20[0.011],9999,[0.011],HoneycombCode
99,7,92,20,20[0.011],9999,[0.011],HoneycombCode
100,3,97,20,20[0.012],9999,[0.012],HoneycombCode
100,6,94,20,20[0.012],9999,[0.012],HoneycombCode
200,13,187,20,20[0.012],9999,[0.012],HoneycombCode
200,10,190,20,20[0.012],9999,[0.012],HoneycombCode
85,3,82,20,20[0.012],9999,[0.012],HoneycombCode
200,13,187,20,20[0.012],9999,[0.012],HoneycombCode
7,0,7,20,20[0.012],9999,[0.012],HoneycombCode
14,0,14,20,20[0.012],9999,[0.012],HoneycombCode
173,7,166,20,20[0.012],9999,[0.012],HoneycombCode
224,13,211,20,20[0.012],9999,[0.012],HoneycombCode
400,14,386,20,20[0.012],9999,[0.012],HoneycombCode
24,0,24,20,20[0.012],9999,[0.012],HoneycombCode
248,10,238,20,20[0.012],9999,[0.012],HoneycombCode
100,1,99,20,20[0.013],9999,[0.013],HoneycombCode
100,4,96,20,20[0.013],9999,[0.013],HoneycombCode
200,6,194,20,20[0.013],9999,[0.013],HoneycombCode
200,6,194,20,20[0.013],9999,[0.013],HoneycombCode
200,6,194,20,20[0.013],9999,[0.013],HoneycombCode
224,8,216,20,20[0.013],9999,[0.013],HoneycombCode
400,6,394,20,20[0.013],9999,[0.013],HoneycombCode
84,1,83,20,20[0.013],9999,[0.013],HoneycombCode
100,0,100,20,20[0.014],9999,[0.014],HoneycombCode
100,3,97,20,20[0.014],9999,[0.014],HoneycombCode
35,0,35,20,20[0.014],9999,[0.014],HoneycombCode
200,5,195,20,20[0.014],9999,[0.014],HoneycombCode
200,2,198,20,20[0.014],9999,[0.014],HoneycombCode
9,0,9,20,20[0.014],9999,[0.014],HoneycombCode
12,0,12,20,20[0.014],9999,[0.014],HoneycombCode
15,0,15,20,20[0.014],9999,[0.014],HoneycombCode
3,0,3,20,20[0.014],9999,[0.014],HoneycombCode
7,0,7,20,20[0.014],9999,[0.014],HoneycombCode
400,4,396,20,20[0.014],9999,[0.014],HoneycombCode
100,0,100,20,20[0.015],9999,[0.015],HoneycombCode
100,0,100,20,20[0.015],9999,[0.015],HoneycombCode
200,6,194,20,20[0.015],9999,[0.015],HoneycombCode
200,2,198,20,20[0.015],9999,[0.015],HoneycombCode
385,5,380,20,20[0.015],9999,[0.015],HoneycombCode
100,0,100,20,20[0.016],9999,[0.016],HoneycombCode
100,0,100,20,20[0.016],9999,[0.016],HoneycombCode
200,2,198,20,20[0.016],9999,[0.016],HoneycombCode
90,0,90,20,20[0.016],9999,[0.016],HoneycombCode
200,1,199,20,20[0.016],9999,[0.016],HoneycombCode
100,0,100,20,20[0.017],9999,[0.017],HoneycombCode
77,0,77,20,20[0.017],9999,[0.017],HoneycombCode
200,0,200,20,20[0.017],9999,[0.017],HoneycombCode
200,1,199,20,20[0.017],9999,[0.017],HoneycombCode
100,46,54,50,50[0.006],9999,[0.006],HoneycombCode
100,57,43,50,50[0.006],9999,[0.006],HoneycombCode
200,100,100,50,50[0.006],9999,[0.006],HoneycombCode
200,104,96,50,50[0.006],9999,[0.006],HoneycombCode
200,111,89,50,50[0.006],9999,[0.006],HoneycombCode
400,202,198,50,50[0.006],9999,[0.006],HoneycombCode
400,198,202,50,50[0.006],9999,[0.006],HoneycombCode
800,416,384,50,50[0.006],9999,[0.006],HoneycombCode
400,214,186,50,50[0.006],9999,[0.006],HoneycombCode
1200,606,594,50,50[0.006],9999,[0.006],HoneycombCode
1200,601,599,50,50[0.006],9999,[0.006],HoneycombCode
2400,1215,1185,50,50[0.006],9999,[0.006],HoneycombCode
2400,1230,1170,50,50[0.006],9999,[0.006],HoneycombCode
100,42,58,50,50[0.007],9999,[0.007],HoneycombCode
100,47,53,50,50[0.007],9999,[0.007],HoneycombCode
200,89,111,50,50[0.007],9999,[0.007],HoneycombCode
200,80,120,50,50[0.007],9999,[0.007],HoneycombCode
200,82,118,50,50[0.007],9999,[0.007],HoneycombCode
400,142,258,50,50[0.007],9999,[0.007],HoneycombCode
400,161,239,50,50[0.007],9999,[0.007],HoneycombCode
800,331,469,50,50[0.007],9999,[0.007],HoneycombCode
1200,498,702,50,50[0.007],9999,[0.007],HoneycombCode
1200,507,693,50,50[0.007],9999,[0.007],HoneycombCode
400,159,241,50,50[0.007],9999,[0.007],HoneycombCode
2400,1017,1383,50,50[0.007],9999,[0.007],HoneycombCode
2400,1018,1382,50,50[0.007],9999,[0.007],HoneycombCode
100,23,77,50,50[0.009],9999,[0.009],HoneycombCode
100,27,73,50,50[0.009],9999,[0.009],HoneycombCode
200,40,160,50,50[0.009],9999,[0.009],HoneycombCode
200,47,153,50,50[0.009],9999,[0.009],HoneycombCode
200,51,149,50,50[0.009],9999,[0.009],HoneycombCode
400,88,312,50,50[0.009],9999,[0.009],HoneycombCode
400,106,294,50,50[0.009],9999,[0.009],HoneycombCode
800,190,610,50,50[0.009],9999,[0.009],HoneycombCode
1200,259,941,50,50[0.009],9999,[0.009],HoneycombCode
1200,267,933,50,50[0.009],9999,[0.009],HoneycombCode
1327,305,1022,50,50[0.009],9999,[0.009],HoneycombCode
2400,548,1852,50,50[0.009],9999,[0.009],HoneycombCode
100,15,85,50,50[0.01],9999,[0.01],HoneycombCode
100,14,86,50,50[0.01],9999,[0.01],HoneycombCode
200,36,164,50,50[0.01],9999,[0.01],HoneycombCode
200,35,165,50,50[0.01],9999,[0.01],HoneycombCode
200,33,167,50,50[0.01],9999,[0.01],HoneycombCode
400,66,334,50,50[0.01],9999,[0.01],HoneycombCode
400,63,337,50,50[0.01],9999,[0.01],HoneycombCode
742,130,612,50,50[0.01],9999,[0.01],HoneycombCode
800,139,661,50,50[0.01],9999,[0.01],HoneycombCode
1200,198,1002,50,50[0.01],9999,[0.01],HoneycombCode
100,7,93,50,50[0.011],9999,[0.011],HoneycombCode
100,7,93,50,50[0.011],9999,[0.011],HoneycombCode
200,25,175,50,50[0.011],9999,[0.011],HoneycombCode
200,23,177,50,50[0.011],9999,[0.011],HoneycombCode
200,26,174,50,50[0.011],9999,[0.011],HoneycombCode
400,39,361,50,50[0.011],9999,[0.011],HoneycombCode
400,37,363,50,50[0.011],9999,[0.011],HoneycombCode
490,67,423,50,50[0.011],9999,[0.011],HoneycombCode
547,48,499,50,50[0.011],9999,[0.011],HoneycombCode
800,105,695,50,50[0.011],9999,[0.011],HoneycombCode
100,7,93,50,50[0.012],9999,[0.012],HoneycombCode
100,7,93,50,50[0.012],9999,[0.012],HoneycombCode
200,17,183,50,50[0.012],9999,[0.012],HoneycombCode
200,18,182,50,50[0.012],9999,[0.012],HoneycombCode
200,16,184,50,50[0.012],9999,[0.012],HoneycombCode
400,30,370,50,50[0.012],9999,[0.012],HoneycombCode
294,23,271,50,50[0.012],9999,[0.012],HoneycombCode
285,16,269,50,50[0.012],9999,[0.012],HoneycombCode
800,44,756,50,50[0.012],9999,[0.012],HoneycombCode
100,6,94,50,50[0.013],9999,[0.013],HoneycombCode
100,6,94,50,50[0.013],9999,[0.013],HoneycombCode
200,8,192,50,50[0.013],9999,[0.013],HoneycombCode
200,12,188,50,50[0.013],9999,[0.013],HoneycombCode
200,7,193,50,50[0.013],9999,[0.013],HoneycombCode
25,2,23,50,50[0.013],9999,[0.013],HoneycombCode
19,1,18,50,50[0.013],9999,[0.013],HoneycombCode
7,0,7,50,50[0.013],9999,[0.013],HoneycombCode
13,3,10,50,50[0.013],9999,[0.013],HoneycombCode
275,11,264,50,50[0.013],9999,[0.013],HoneycombCode
400,8,392,50,50[0.013],9999,[0.013],HoneycombCode
100,3,97,50,50[0.014],9999,[0.014],HoneycombCode
100,1,99,50,50[0.014],9999,[0.014],HoneycombCode
90,3,87,50,50[0.014],9999,[0.014],HoneycombCode
200,3,197,50,50[0.014],9999,[0.014],HoneycombCode
41,1,40,50,50[0.014],9999,[0.014],HoneycombCode
200,5,195,50,50[0.014],9999,[0.014],HoneycombCode
126,4,122,50,50[0.014],9999,[0.014],HoneycombCode
12,0,12,50,50[0.014],9999,[0.014],HoneycombCode
2,0,2,50,50[0.014],9999,[0.014],HoneycombCode
3,0,3,50,50[0.014],9999,[0.014],HoneycombCode
3,0,3,50,50[0.014],9999,[0.014],HoneycombCode
135,1,134,50,50[0.014],9999,[0.014],HoneycombCode
4,0,4,50,50[0.014],9999,[0.014],HoneycombCode
100,1,99,50,50[0.015],9999,[0.015],HoneycombCode
77,1,76,50,50[0.015],9999,[0.015],HoneycombCode
200,0,200,50,50[0.015],9999,[0.015],HoneycombCode
31,1,30,50,50[0.015],9999,[0.015],HoneycombCode
200,2,198,50,50[0.015],9999,[0.015],HoneycombCode
65,1,64,50,50[0.015],9999,[0.015],HoneycombCode
186,4,182,50,50[0.015],9999,[0.015],HoneycombCode
100,1,99,50,50[0.016],9999,[0.016],HoneycombCode
100,0,100,50,50[0.016],9999,[0.016],HoneycombCode
46,0,46,50,50[0.016],9999,[0.016],HoneycombCode
200,3,197,50,50[0.016],9999,[0.016],HoneycombCode
200,3,197,50,50[0.016],9999,[0.016],HoneycombCode
41,0,41,50,50[0.016],9999,[0.016],HoneycombCode
93,1,92,50,50[0.016],9999,[0.016],HoneycombCode
100,1,99,50,50[0.017],9999,[0.017],HoneycombCode
20,0,20,50,50[0.017],9999,[0.017],HoneycombCode
46,0,46,50,50[0.017],9999,[0.017],HoneycombCode
95,0,95,50,50[0.017],9999,[0.017],HoneycombCode
200,0,200,50,50[0.017],9999,[0.017],HoneycombCode
200,2,198,50,50[0.017],9999,[0.017],HoneycombCode
100,72,28,200,200[0.006],9999,[0.006],HoneycombCode
100,65,35,200,200[0.006],9999,[0.006],HoneycombCode
200,122,78,200,200[0.006],9999,[0.006],HoneycombCode
200,120,80,200,200[0.006],9999,[0.006],HoneycombCode
200,121,79,200,200[0.006],9999,[0.006],HoneycombCode
400,236,164,200,200[0.006],9999,[0.006],HoneycombCode
400,239,161,200,200[0.006],9999,[0.006],HoneycombCode
800,487,313,200,200[0.006],9999,[0.006],HoneycombCode
400,260,140,200,200[0.006],9999,[0.006],HoneycombCode
1200,742,458,200,200[0.006],9999,[0.006],HoneycombCode
1200,731,469,200,200[0.006],9999,[0.006],HoneycombCode
1033,623,410,200,200[0.006],9999,[0.006],HoneycombCode
1367,851,516,200,200[0.006],9999,[0.006],HoneycombCode
1117,708,409,200,200[0.006],9999,[0.006],HoneycombCode
1283,762,521,200,200[0.006],9999,[0.006],HoneycombCode
100,53,47,200,200[0.007],9999,[0.007],HoneycombCode
100,56,44,200,200[0.007],9999,[0.007],HoneycombCode
200,106,94,200,200[0.007],9999,[0.007],HoneycombCode
200,104,96,200,200[0.007],9999,[0.007],HoneycombCode
200,100,100,200,200[0.007],9999,[0.007],HoneycombCode
3,0,3,200,200[0.007],9999,[0.007],HoneycombCode
18,8,10,200,200[0.007],9999,[0.007],HoneycombCode
400,193,207,200,200[0.007],9999,[0.007],HoneycombCode
108,62,46,200,200[0.007],9999,[0.007],HoneycombCode
400,208,192,200,200[0.007],9999,[0.007],HoneycombCode
144,81,63,200,200[0.007],9999,[0.007],HoneycombCode
58,33,25,200,200[0.007],9999,[0.007],HoneycombCode
800,444,356,200,200[0.007],9999,[0.007],HoneycombCode
648,350,298,200,200[0.007],9999,[0.007],HoneycombCode
1200,651,549,200,200[0.007],9999,[0.007],HoneycombCode
984,509,475,200,200[0.007],9999,[0.007],HoneycombCode
984,511,473,200,200[0.007],9999,[0.007],HoneycombCode
1197,626,571,200,200[0.007],9999,[0.007],HoneycombCode
1128,591,537,200,200[0.007],9999,[0.007],HoneycombCode
1128,575,553,200,200[0.007],9999,[0.007],HoneycombCode
100,35,65,200,200[0.009],9999,[0.009],HoneycombCode
100,32,68,200,200[0.009],9999,[0.009],HoneycombCode
200,64,136,200,200[0.009],9999,[0.009],HoneycombCode
200,68,132,200,200[0.009],9999,[0.009],HoneycombCode
200,67,133,200,200[0.009],9999,[0.009],HoneycombCode
400,135,265,200,200[0.009],9999,[0.009],HoneycombCode
180,62,118,200,200[0.009],9999,[0.009],HoneycombCode
400,135,265,200,200[0.009],9999,[0.009],HoneycombCode
148,44,104,200,200[0.009],9999,[0.009],HoneycombCode
293,106,187,200,200[0.009],9999,[0.009],HoneycombCode
146,52,94,200,200[0.009],9999,[0.009],HoneycombCode
107,28,79,200,200[0.009],9999,[0.009],HoneycombCode
800,274,526,200,200[0.009],9999,[0.009],HoneycombCode
907,303,604,200,200[0.009],9999,[0.009],HoneycombCode
1020,351,669,200,200[0.009],9999,[0.009],HoneycombCode
265,87,178,200,200[0.009],9999,[0.009],HoneycombCode
321,111,210,200,200[0.009],9999,[0.009],HoneycombCode
516,169,347,200,200[0.009],9999,[0.009],HoneycombCode
100,20,80,200,200[0.01],9999,[0.01],HoneycombCode
100,23,77,200,200[0.01],9999,[0.01],HoneycombCode
200,51,149,200,200[0.01],9999,[0.01],HoneycombCode
200,53,147,200,200[0.01],9999,[0.01],HoneycombCode
200,46,154,200,200[0.01],9999,[0.01],HoneycombCode
400,114,286,200,200[0.01],9999,[0.01],HoneycombCode
284,73,211,200,200[0.01],9999,[0.01],HoneycombCode
400,96,304,200,200[0.01],9999,[0.01],HoneycombCode
148,39,109,200,200[0.01],9999,[0.01],HoneycombCode
404,118,286,200,200[0.01],9999,[0.01],HoneycombCode
800,221,579,200,200[0.01],9999,[0.01],HoneycombCode
326,82,244,200,200[0.01],9999,[0.01],HoneycombCode
436,107,329,200,200[0.01],9999,[0.01],HoneycombCode
464,108,356,200,200[0.01],9999,[0.01],HoneycombCode
916,238,678,200,200[0.01],9999,[0.01],HoneycombCode
796,196,600,200,200[0.01],9999,[0.01],HoneycombCode
100,22,78,200,200[0.011],9999,[0.011],HoneycombCode
100,18,82,200,200[0.011],9999,[0.011],HoneycombCode
200,24,176,200,200[0.011],9999,[0.011],HoneycombCode
200,36,164,200,200[0.011],9999,[0.011],HoneycombCode
200,32,168,200,200[0.011],9999,[0.011],HoneycombCode
144,24,120,200,200[0.011],9999,[0.011],HoneycombCode
291,56,235,200,200[0.011],9999,[0.011],HoneycombCode
10,0,10,200,200[0.011],9999,[0.011],HoneycombCode
400,76,324,200,200[0.011],9999,[0.011],HoneycombCode
18,1,17,200,200[0.011],9999,[0.011],HoneycombCode
26,5,21,200,200[0.011],9999,[0.011],HoneycombCode
329,64,265,200,200[0.011],9999,[0.011],HoneycombCode
96,9,87,200,200[0.011],9999,[0.011],HoneycombCode
1,0,1,200,200[0.011],9999,[0.011],HoneycombCode
33,9,24,200,200[0.011],9999,[0.011],HoneycombCode
1,1,0,200,200[0.011],9999,[0.011],HoneycombCode
1,0,1,200,200[0.011],9999,[0.011],HoneycombCode
1,0,1,200,200[0.011],9999,[0.011],HoneycombCode
1,0,1,200,200[0.011],9999,[0.011],HoneycombCode
1,0,1,200,200[0.011],9999,[0.011],HoneycombCode
1,0,1,200,200[0.011],9999,[0.011],HoneycombCode
1,0,1,200,200[0.011],9999,[0.011],HoneycombCode
39,8,31,200,200[0.011],9999,[0.011],HoneycombCode
299,42,257,200,200[0.011],9999,[0.011],HoneycombCode
75,12,63,200,200[0.011],9999,[0.011],HoneycombCode
100,8,92,200,200[0.012],9999,[0.012],HoneycombCode
100,13,87,200,200[0.012],9999,[0.012],HoneycombCode
200,22,178,200,200[0.012],9999,[0.012],HoneycombCode
200,22,178,200,200[0.012],9999,[0.012],HoneycombCode
150,24,126,200,200[0.012],9999,[0.012],HoneycombCode
107,17,90,200,200[0.012],9999,[0.012],HoneycombCode
25,5,20,200,200[0.012],9999,[0.012],HoneycombCode
182,22,160,200,200[0.012],9999,[0.012],HoneycombCode
48,6,42,200,200[0.012],9999,[0.012],HoneycombCode
172,30,142,200,200[0.012],9999,[0.012],HoneycombCode
114,12,102,200,200[0.012],9999,[0.012],HoneycombCode
40,5,35,200,200[0.012],9999,[0.012],HoneycombCode
14,2,12,200,200[0.012],9999,[0.012],HoneycombCode
18,2,16,200,200[0.012],9999,[0.012],HoneycombCode
400,52,348,200,200[0.012],9999,[0.012],HoneycombCode
96,8,88,200,200[0.012],9999,[0.012],HoneycombCode
60,13,47,200,200[0.012],9999,[0.012],HoneycombCode
100,9,91,200,200[0.013],9999,[0.013],HoneycombCode
100,9,91,200,200[0.013],9999,[0.013],HoneycombCode
35,1,34,200,200[0.013],9999,[0.013],HoneycombCode
200,17,183,200,200[0.013],9999,[0.013],HoneycombCode
69,3,66,200,200[0.013],9999,[0.013],HoneycombCode
200,13,187,200,200[0.013],9999,[0.013],HoneycombCode
179,15,164,200,200[0.013],9999,[0.013],HoneycombCode
400,34,366,200,200[0.013],9999,[0.013],HoneycombCode
100,5,95,200,200[0.014],9999,[0.014],HoneycombCode
100,2,98,200,200[0.014],9999,[0.014],HoneycombCode
200,9,191,200,200[0.014],9999,[0.014],HoneycombCode
200,15,185,200,200[0.014],9999,[0.014],HoneycombCode
46,1,45,200,200[0.014],9999,[0.014],HoneycombCode
26,1,25,200,200[0.014],9999,[0.014],HoneycombCode
385,20,365,200,200[0.014],9999,[0.014],HoneycombCode
100,2,98,200,200[0.015],9999,[0.015],HoneycombCode
77,5,72,200,200[0.015],9999,[0.015],HoneycombCode
55,2,53,200,200[0.015],9999,[0.015],HoneycombCode
200,8,192,200,200[0.015],9999,[0.015],HoneycombCode
200,6,194,200,200[0.015],9999,[0.015],HoneycombCode
7,0,7,200,200[0.015],9999,[0.015],HoneycombCode
33,3,30,200,200[0.015],9999,[0.015],HoneycombCode
100,3,97,200,200[0.016],9999,[0.016],HoneycombCode
172,3,169,200,200[0.016],9999,[0.016],HoneycombCode
200,3,197,200,200[0.016],9999,[0.016],HoneycombCode
101,4,97,200,200[0.016],9999,[0.016],HoneycombCode
18,0,18,200,200[0.016],9999,[0.016],HoneycombCode
18,1,17,200,200[0.016],9999,[0.016],HoneycombCode
100,0,100,200,200[0.017],9999,[0.017],HoneycombCode
77,1,76,200,200[0.017],9999,[0.017],HoneycombCode
55,0,55,200,200[0.017],9999,[0.017],HoneycombCode
200,0,200,200,200[0.017],9999,[0.017],HoneycombCode
200,1,199,200,200[0.017],9999,[0.017],HoneycombCode
100,20,80,10,10[0.008],9999,[0.008],HoneycombCode
100,15,85,10,10[0.008],9999,[0.008],HoneycombCode
200,40,160,10,10[0.008],9999,[0.008],HoneycombCode
200,42,158,10,10[0.008],9999,[0.008],HoneycombCode
200,44,156,10,10[0.008],9999,[0.008],HoneycombCode
400,85,315,10,10[0.008],9999,[0.008],HoneycombCode
400,67,333,10,10[0.008],9999,[0.008],HoneycombCode
800,162,638,10,10[0.008],9999,[0.008],HoneycombCode
1200,241,959,10,10[0.008],9999,[0.008],HoneycombCode
1200,241,959,10,10[0.008],9999,[0.008],HoneycombCode
400,71,329,10,10[0.008],9999,[0.008],HoneycombCode
2400,458,1942,10,10[0.008],9999,[0.008],HoneycombCode
2400,453,1947,10,10[0.008],9999,[0.008],HoneycombCode
100,22,78,20,20[0.008],9999,[0.008],HoneycombCode
100,25,75,20,20[0.008],9999,[0.008],HoneycombCode
200,44,156,20,20[0.008],9999,[0.008],HoneycombCode
200,45,155,20,20[0.008],9999,[0.008],HoneycombCode
200,60,140,20,20[0.008],9999,[0.008],HoneycombCode
400,113,287,20,20[0.008],9999,[0.008],HoneycombCode
400,90,310,20,20[0.008],9999,[0.008],HoneycombCode
800,221,579,20,20[0.008],9999,[0.008],HoneycombCode
1200,295,905,20,20[0.008],9999,[0.008],HoneycombCode
1200,305,895,20,20[0.008],9999,[0.008],HoneycombCode
731,199,532,20,20[0.008],9999,[0.008],HoneycombCode
1961,485,1476,20,20[0.008],9999,[0.008],HoneycombCode
2400,580,1820,20,20[0.008],9999,[0.008],HoneycombCode
100,24,76,50,50[0.008],9999,[0.008],HoneycombCode
100,34,66,50,50[0.008],9999,[0.008],HoneycombCode
200,65,135,50,50[0.008],9999,[0.008],HoneycombCode
200,63,137,50,50[0.008],9999,[0.008],HoneycombCode
200,57,143,50,50[0.008],9999,[0.008],HoneycombCode
400,139,261,50,50[0.008],9999,[0.008],HoneycombCode
400,121,279,50,50[0.008],9999,[0.008],HoneycombCode
800,234,566,50,50[0.008],9999,[0.008],HoneycombCode
1200,398,802,50,50[0.008],9999,[0.008],HoneycombCode
1200,370,830,50,50[0.008],9999,[0.008],HoneycombCode
400,135,265,50,50[0.008],9999,[0.008],HoneycombCode
2400,796,1604,50,50[0.008],9999,[0.008],HoneycombCode
2400,779,1621,50,50[0.008],9999,[0.008],HoneycombCode
100,50,50,200,200[0.008],9999,[0.008],HoneycombCode
100,41,59,200,200[0.008],9999,[0.008],HoneycombCode
200,98,102,200,200[0.008],9999,[0.008],HoneycombCode
200,87,113,200,200[0.008],9999,[0.008],HoneycombCode
200,86,114,200,200[0.008],9999,[0.008],HoneycombCode
91,42,49,200,200[0.008],9999,[0.008],HoneycombCode
400,186,214,200,200[0.008],9999,[0.008],HoneycombCode
400,156,244,200,200[0.008],9999,[0.008],HoneycombCode
312,142,170,200,200[0.008],9999,[0.008],HoneycombCode
800,370,430,200,200[0.008],9999,[0.008],HoneycombCode
546,244,302,200,200[0.008],9999,[0.008],HoneycombCode
552,233,319,200,200[0.008],9999,[0.008],HoneycombCode
1044,448,596,200,200[0.008],9999,[0.008],HoneycombCode
1200,522,678,200,200[0.008],9999,[0.008],HoneycombCode
1109,465,644,200,200[0.008],9999,[0.008],HoneycombCode
676,274,402,200,200[0.008],9999,[0.008],HoneycombCode
1044,449,595,200,200[0.008],9999,[0.008],HoneycombCode
610,254,356,200,200[0.008],9999,[0.008],HoneycombCode
416,180,236,200,200[0.008],9999,[0.008],HoneycombCode
100,65,35,500,500[0.006],9999,[0.006],HoneycombCode
100,60,40,500,500[0.006],9999,[0.006],HoneycombCode
200,125,75,500,500[0.006],9999,[0.006],HoneycombCode
200,137,63,500,500[0.006],9999,[0.006],HoneycombCode
200,122,78,500,500[0.006],9999,[0.006],HoneycombCode
400,260,140,500,500[0.006],9999,[0.006],HoneycombCode
400,254,146,500,500[0.006],9999,[0.006],HoneycombCode
464,291,173,500,500[0.006],9999,[0.006],HoneycombCode
355,227,128,500,500[0.006],9999,[0.006],HoneycombCode
736,497,239,500,500[0.006],9999,[0.006],HoneycombCode
611,423,188,500,500[0.006],9999,[0.006],HoneycombCode
800,502,298,500,500[0.006],9999,[0.006],HoneycombCode
547,371,176,500,500[0.006],9999,[0.006],HoneycombCode
567,359,208,500,500[0.006],9999,[0.006],HoneycombCode
611,411,200,500,500[0.006],9999,[0.006],HoneycombCode
611,406,205,500,500[0.006],9999,[0.006],HoneycombCode
23,17,6,500,500[0.006],9999,[0.006],HoneycombCode
419,278,141,500,500[0.006],9999,[0.006],HoneycombCode
482,328,154,500,500[0.006],9999,[0.006],HoneycombCode
845,546,299,500,500[0.006],9999,[0.006],HoneycombCode
377,238,139,500,500[0.006],9999,[0.006],HoneycombCode
314,205,109,500,500[0.006],9999,[0.006],HoneycombCode
298,187,111,500,500[0.006],9999,[0.006],HoneycombCode
340,228,112,500,500[0.006],9999,[0.006],HoneycombCode
100,57,43,500,500[0.007],9999,[0.007],HoneycombCode
100,60,40,500,500[0.007],9999,[0.007],HoneycombCode
200,127,73,500,500[0.007],9999,[0.007],HoneycombCode
200,121,79,500,500[0.007],9999,[0.007],HoneycombCode
200,115,85,500,500[0.007],9999,[0.007],HoneycombCode
8,3,5,500,500[0.007],9999,[0.007],HoneycombCode
48,27,21,500,500[0.007],9999,[0.007],HoneycombCode
400,236,164,500,500[0.007],9999,[0.007],HoneycombCode
473,280,193,500,500[0.007],9999,[0.007],HoneycombCode
532,332,200,500,500[0.007],9999,[0.007],HoneycombCode
288,165,123,500,500[0.007],9999,[0.007],HoneycombCode
668,404,264,500,500[0.007],9999,[0.007],HoneycombCode
596,343,253,500,500[0.007],9999,[0.007],HoneycombCode
596,328,268,500,500[0.007],9999,[0.007],HoneycombCode
727,413,314,500,500[0.007],9999,[0.007],HoneycombCode
437,237,200,500,500[0.007],9999,[0.007],HoneycombCode
437,272,165,500,500[0.007],9999,[0.007],HoneycombCode
437,264,173,500,500[0.007],9999,[0.007],HoneycombCode
326,182,144,500,500[0.007],9999,[0.007],HoneycombCode
377,220,157,500,500[0.007],9999,[0.007],HoneycombCode
351,210,141,500,500[0.007],9999,[0.007],HoneycombCode
267,157,110,500,500[0.007],9999,[0.007],HoneycombCode
250,159,91,500,500[0.007],9999,[0.007],HoneycombCode
280,163,117,500,500[0.007],9999,[0.007],HoneycombCode
298,173,125,500,500[0.007],9999,[0.007],HoneycombCode
244,140,104,500,500[0.007],9999,[0.007],HoneycombCode
238,148,90,500,500[0.007],9999,[0.007],HoneycombCode
258,143,115,500,500[0.007],9999,[0.007],HoneycombCode
229,128,101,500,500[0.007],9999,[0.007],HoneycombCode
233,140,93,500,500[0.007],9999,[0.007],HoneycombCode
202,113,89,500,500[0.007],9999,[0.007],HoneycombCode
100,27,73,500,500[0.009],9999,[0.009],HoneycombCode
100,37,63,500,500[0.009],9999,[0.009],HoneycombCode
200,77,123,500,500[0.009],9999,[0.009],HoneycombCode
200,72,128,500,500[0.009],9999,[0.009],HoneycombCode
200,76,124,500,500[0.009],9999,[0.009],HoneycombCode
130,50,80,500,500[0.009],9999,[0.009],HoneycombCode
276,106,170,500,500[0.009],9999,[0.009],HoneycombCode
400,160,240,500,500[0.009],9999,[0.009],HoneycombCode
535,217,318,500,500[0.009],9999,[0.009],HoneycombCode
462,199,263,500,500[0.009],9999,[0.009],HoneycombCode
333,131,202,500,500[0.009],9999,[0.009],HoneycombCode
393,164,229,500,500[0.009],9999,[0.009],HoneycombCode
462,190,272,500,500[0.009],9999,[0.009],HoneycombCode
535,210,325,500,500[0.009],9999,[0.009],HoneycombCode
393,162,231,500,500[0.009],9999,[0.009],HoneycombCode
393,145,248,500,500[0.009],9999,[0.009],HoneycombCode
45,18,27,500,500[0.009],9999,[0.009],HoneycombCode
248,107,141,500,500[0.009],9999,[0.009],HoneycombCode
219,77,142,500,500[0.009],9999,[0.009],HoneycombCode
208,87,121,500,500[0.009],9999,[0.009],HoneycombCode
195,71,124,500,500[0.009],9999,[0.009],HoneycombCode
183,76,107,500,500[0.009],9999,[0.009],HoneycombCode
124,51,73,500,500[0.009],9999,[0.009],HoneycombCode
175,74,101,500,500[0.009],9999,[0.009],HoneycombCode
161,75,86,500,500[0.009],9999,[0.009],HoneycombCode
169,62,107,500,500[0.009],9999,[0.009],HoneycombCode
100,49,51,500,500[0.008],9999,[0.008],HoneycombCode
100,53,47,500,500[0.008],9999,[0.008],HoneycombCode
200,95,105,500,500[0.008],9999,[0.008],HoneycombCode
200,94,106,500,500[0.008],9999,[0.008],HoneycombCode
48,23,25,500,500[0.008],9999,[0.008],HoneycombCode
200,93,107,500,500[0.008],9999,[0.008],HoneycombCode
400,185,215,500,500[0.008],9999,[0.008],HoneycombCode
288,146,142,500,500[0.008],9999,[0.008],HoneycombCode
278,143,135,500,500[0.008],9999,[0.008],HoneycombCode
461,235,226,500,500[0.008],9999,[0.008],HoneycombCode
576,308,268,500,500[0.008],9999,[0.008],HoneycombCode
461,228,233,500,500[0.008],9999,[0.008],HoneycombCode
608,322,286,500,500[0.008],9999,[0.008],HoneycombCode
396,204,192,500,500[0.008],9999,[0.008],HoneycombCode
592,292,300,500,500[0.008],9999,[0.008],HoneycombCode
576,275,301,500,500[0.008],9999,[0.008],HoneycombCode
396,205,191,500,500[0.008],9999,[0.008],HoneycombCode
288,150,138,500,500[0.008],9999,[0.008],HoneycombCode
329,157,172,500,500[0.008],9999,[0.008],HoneycombCode
265,139,126,500,500[0.008],9999,[0.008],HoneycombCode
208,102,106,500,500[0.008],9999,[0.008],HoneycombCode
201,100,101,500,500[0.008],9999,[0.008],HoneycombCode
243,127,116,500,500[0.008],9999,[0.008],HoneycombCode
223,116,107,500,500[0.008],9999,[0.008],HoneycombCode
191,92,99,500,500[0.008],9999,[0.008],HoneycombCode
214,101,113,500,500[0.008],9999,[0.008],HoneycombCode
185,91,94,500,500[0.008],9999,[0.008],HoneycombCode
189,95,94,500,500[0.008],9999,[0.008],HoneycombCode
195,86,109,500,500[0.008],9999,[0.008],HoneycombCode
43,18,25,500,500[0.008],9999,[0.008],HoneycombCode
186,90,96,500,500[0.008],9999,[0.008],HoneycombCode
41,20,21,500,500[0.008],9999,[0.008],HoneycombCode
79,44,35,500,500[0.008],9999,[0.008],HoneycombCode
43,28,15,500,500[0.008],9999,[0.008],HoneycombCode
32,17,15,500,500[0.008],9999,[0.008],HoneycombCode
184,88,96,500,500[0.008],9999,[0.008],HoneycombCode
34,13,21,500,500[0.008],9999,[0.008],HoneycombCode
148,83,65,500,500[0.008],9999,[0.008],HoneycombCode
35,19,16,500,500[0.008],9999,[0.008],HoneycombCode
36,19,17,500,500[0.008],9999,[0.008],HoneycombCode
95,59,36,500,500[0.008],9999,[0.008],HoneycombCode
37,18,19,500,500[0.008],9999,[0.008],HoneycombCode
38,20,18,500,500[0.008],9999,[0.008],HoneycombCode
153,77,76,500,500[0.008],9999,[0.008],HoneycombCode
38,18,20,500,500[0.008],9999,[0.008],HoneycombCode
156,76,80,500,500[0.008],9999,[0.008],HoneycombCode
100,25,75,500,500[0.01],9999,[0.01],HoneycombCode
100,37,63,500,500[0.01],9999,[0.01],HoneycombCode
200,48,152,500,500[0.01],9999,[0.01],HoneycombCode
200,67,133,500,500[0.01],9999,[0.01],HoneycombCode
48,21,27,500,500[0.01],9999,[0.01],HoneycombCode
200,68,132,500,500[0.01],9999,[0.01],HoneycombCode
114,26,88,500,500[0.01],9999,[0.01],HoneycombCode
400,131,269,500,500[0.01],9999,[0.01],HoneycombCode
288,97,191,500,500[0.01],9999,[0.01],HoneycombCode
362,109,253,500,500[0.01],9999,[0.01],HoneycombCode
384,106,278,500,500[0.01],9999,[0.01],HoneycombCode
362,120,242,500,500[0.01],9999,[0.01],HoneycombCode
297,97,200,500,500[0.01],9999,[0.01],HoneycombCode
362,126,236,500,500[0.01],9999,[0.01],HoneycombCode
49,19,30,500,500[0.01],9999,[0.01],HoneycombCode
241,72,169,500,500[0.01],9999,[0.01],HoneycombCode
384,133,251,500,500[0.01],9999,[0.01],HoneycombCode
384,126,258,500,500[0.01],9999,[0.01],HoneycombCode
100,15,85,500,500[0.011],9999,[0.011],HoneycombCode
100,25,75,500,500[0.011],9999,[0.011],HoneycombCode
200,52,148,500,500[0.011],9999,[0.011],HoneycombCode
200,40,160,500,500[0.011],9999,[0.011],HoneycombCode
10,4,6,500,500[0.011],9999,[0.011],HoneycombCode
45,11,34,500,500[0.011],9999,[0.011],HoneycombCode
200,51,149,500,500[0.011],9999,[0.011],HoneycombCode
400,78,322,500,500[0.011],9999,[0.011],HoneycombCode
258,55,203,500,500[0.011],9999,[0.011],HoneycombCode
418,94,324,500,500[0.011],9999,[0.011],HoneycombCode
387,95,292,500,500[0.011],9999,[0.011],HoneycombCode
418,87,331,500,500[0.011],9999,[0.011],HoneycombCode
304,73,231,500,500[0.011],9999,[0.011],HoneycombCode
100,12,88,500,500[0.012],9999,[0.012],HoneycombCode
100,10,90,500,500[0.012],9999,[0.012],HoneycombCode
200,36,164,500,500[0.012],9999,[0.012],HoneycombCode
200,34,166,500,500[0.012],9999,[0.012],HoneycombCode
27,3,24,500,500[0.012],9999,[0.012],HoneycombCode
200,32,168,500,500[0.012],9999,[0.012],HoneycombCode
391,61,330,500,500[0.012],9999,[0.012],HoneycombCode
391,64,327,500,500[0.012],9999,[0.012],HoneycombCode
400,66,334,500,500[0.012],9999,[0.012],HoneycombCode
391,66,325,500,500[0.012],9999,[0.012],HoneycombCode
100,9,91,500,500[0.013],9999,[0.013],HoneycombCode
100,11,89,500,500[0.013],9999,[0.013],HoneycombCode
200,36,164,500,500[0.013],9999,[0.013],HoneycombCode
200,24,176,500,500[0.013],9999,[0.013],HoneycombCode
60,3,57,500,500[0.013],9999,[0.013],HoneycombCode
200,23,177,500,500[0.013],9999,[0.013],HoneycombCode
400,53,347,500,500[0.013],9999,[0.013],HoneycombCode
392,42,350,500,500[0.013],9999,[0.013],HoneycombCode
100,12,88,500,500[0.014],9999,[0.014],HoneycombCode
100,6,94,500,500[0.014],9999,[0.014],HoneycombCode
35,0,35,500,500[0.014],9999,[0.014],HoneycombCode
200,14,186,500,500[0.014],9999,[0.014],HoneycombCode
200,8,192,500,500[0.014],9999,[0.014],HoneycombCode
400,24,376,500,500[0.014],9999,[0.014],HoneycombCode
100,4,96,500,500[0.015],9999,[0.015],HoneycombCode
100,1,99,500,500[0.015],9999,[0.015],HoneycombCode
46,2,44,500,500[0.015],9999,[0.015],HoneycombCode
200,6,194,500,500[0.015],9999,[0.015],HoneycombCode
41,3,38,500,500[0.015],9999,[0.015],HoneycombCode
8,0,8,500,500[0.015],9999,[0.015],HoneycombCode
200,8,192,500,500[0.015],9999,[0.015],HoneycombCode
12,0,12,500,500[0.015],9999,[0.015],HoneycombCode
5,0,5,500,500[0.015],9999,[0.015],HoneycombCode
55,0,55,500,500[0.015],9999,[0.015],HoneycombCode
6,0,6,500,500[0.015],9999,[0.015],HoneycombCode
4,0,4,500,500[0.015],9999,[0.015],HoneycombCode
4,1,3,500,500[0.015],9999,[0.015],HoneycombCode
4,0,4,500,500[0.015],9999,[0.015],HoneycombCode
5,0,5,500,500[0.015],9999,[0.015],HoneycombCode
5,0,5,500,500[0.015],9999,[0.015],HoneycombCode
71,4,67,500,500[0.015],9999,[0.015],HoneycombCode
100,2,98,500,500[0.016],9999,[0.016],HoneycombCode
47,1,46,500,500[0.016],9999,[0.016],HoneycombCode
88,1,87,500,500[0.016],9999,[0.016],HoneycombCode
21,0,21,500,500[0.016],9999,[0.016],HoneycombCode
200,9,191,500,500[0.016],9999,[0.016],HoneycombCode
200,7,193,500,500[0.016],9999,[0.016],HoneycombCode
100,0,100,500,500[0.017],9999,[0.017],HoneycombCode
100,0,100,500,500[0.017],9999,[0.017],HoneycombCode
8,0,8,500,500[0.017],9999,[0.017],HoneycombCode
7,0,7,500,500[0.017],9999,[0.017],HoneycombCode
2,0,2,500,500[0.017],9999,[0.017],HoneycombCode
200,3,197,500,500[0.017],9999,[0.017],HoneycombCode
200,3,197,500,500[0.017],9999,[0.017],HoneycombCode
6,0,6,500,500[0.017],9999,[0.017],HoneycombCode
100,81,19,20,20[0.003],9999,[0.003],HoneycombCode
200,164,36,20,20[0.003],9999,[0.003],HoneycombCode
100,76,24,20,20[0.003],9999,[0.003],HoneycombCode
200,169,31,20,20[0.003],9999,[0.003],HoneycombCode
600,486,114,20,20[0.003],9999,[0.003],HoneycombCode
600,477,123,20,20[0.003],9999,[0.003],HoneycombCode
600,478,122,20,20[0.003],9999,[0.003],HoneycombCode
1200,990,210,20,20[0.003],9999,[0.003],HoneycombCode
1200,975,225,20,20[0.003],9999,[0.003],HoneycombCode
2800,2261,539,20,20[0.003],9999,[0.003],HoneycombCode
2400,1921,479,20,20[0.003],9999,[0.003],HoneycombCode
100,70,30,20,20[0.004],9999,[0.004],HoneycombCode
100,74,26,20,20[0.004],9999,[0.004],HoneycombCode
200,138,62,20,20[0.004],9999,[0.004],HoneycombCode
200,138,62,20,20[0.004],9999,[0.004],HoneycombCode
200,133,67,20,20[0.004],9999,[0.004],HoneycombCode
400,271,129,20,20[0.004],9999,[0.004],HoneycombCode
400,265,135,20,20[0.004],9999,[0.004],HoneycombCode
800,557,243,20,20[0.004],9999,[0.004],HoneycombCode
1200,847,353,20,20[0.004],9999,[0.004],HoneycombCode
400,274,126,20,20[0.004],9999,[0.004],HoneycombCode
1200,834,366,20,20[0.004],9999,[0.004],HoneycombCode
2400,1683,717,20,20[0.004],9999,[0.004],HoneycombCode
2400,1662,738,20,20[0.004],9999,[0.004],HoneycombCode
100,50,50,20,20[0.005],9999,[0.005],HoneycombCode
100,65,35,20,20[0.005],9999,[0.005],HoneycombCode
200,112,88,20,20[0.005],9999,[0.005],HoneycombCode
200,115,85,20,20[0.005],9999,[0.005],HoneycombCode
200,109,91,20,20[0.005],9999,[0.005],HoneycombCode
400,240,160,20,20[0.005],9999,[0.005],HoneycombCode
400,228,172,20,20[0.005],9999,[0.005],HoneycombCode
800,444,356,20,20[0.005],9999,[0.005],HoneycombCode
1200,665,535,20,20[0.005],9999,[0.005],HoneycombCode
1200,663,537,20,20[0.005],9999,[0.005],HoneycombCode
400,226,174,20,20[0.005],9999,[0.005],HoneycombCode
2400,1354,1046,20,20[0.005],9999,[0.005],HoneycombCode
2400,1368,1032,20,20[0.005],9999,[0.005],HoneycombCode
100,99,1,20,20[0.0009],9999,[0.0009],HoneycombCode
100,97,3,20,20[0.0009],9999,[0.0009],HoneycombCode
200,196,4,20,20[0.0009],9999,[0.0009],HoneycombCode
200,190,10,20,20[0.0009],9999,[0.0009],HoneycombCode
200,196,4,20,20[0.0009],9999,[0.0009],HoneycombCode
400,394,6,20,20[0.0009],9999,[0.0009],HoneycombCode
400,389,11,20,20[0.0009],9999,[0.0009],HoneycombCode
800,781,19,20,20[0.0009],9999,[0.0009],HoneycombCode
1200,1175,25,20,20[0.0009],9999,[0.0009],HoneycombCode
1200,1166,34,20,20[0.0009],9999,[0.0009],HoneycombCode
2400,2362,38,20,20[0.0009],9999,[0.0009],HoneycombCode
2400,2352,48,20,20[0.0009],9999,[0.0009],HoneycombCode
4800,4703,97,20,20[0.0009],9999,[0.0009],HoneycombCode
7200,7049,151,20,20[0.0009],9999,[0.0009],HoneycombCode
7200,7064,136,20,20[0.0009],9999,[0.0009],HoneycombCode
14400,14125,275,20,20[0.0009],9999,[0.0009],HoneycombCode
13600,13335,265,20,20[0.0009],9999,[0.0009],HoneycombCode
14400,14134,266,20,20[0.0009],9999,[0.0009],HoneycombCode
28800,28269,531,20,20[0.0009],9999,[0.0009],HoneycombCode
100,95,5,20,20[0.001],9999,[0.001],HoneycombCode
100,98,2,20,20[0.001],9999,[0.001],HoneycombCode
200,196,4,20,20[0.001],9999,[0.001],HoneycombCode
200,198,2,20,20[0.001],9999,[0.001],HoneycombCode
200,198,2,20,20[0.001],9999,[0.001],HoneycombCode
400,391,9,20,20[0.001],9999,[0.001],HoneycombCode
400,390,10,20,20[0.001],9999,[0.001],HoneycombCode
800,786,14,20,20[0.001],9999,[0.001],HoneycombCode
1200,1173,27,20,20[0.001],9999,[0.001],HoneycombCode
1200,1166,34,20,20[0.001],9999,[0.001],HoneycombCode
2400,2343,57,20,20[0.001],9999,[0.001],HoneycombCode
2400,2334,66,20,20[0.001],9999,[0.001],HoneycombCode
4800,4696,104,20,20[0.001],9999,[0.001],HoneycombCode
7200,7018,182,20,20[0.001],9999,[0.001],HoneycombCode
7200,7016,184,20,20[0.001],9999,[0.001],HoneycombCode
14400,14035,365,20,20[0.001],9999,[0.001],HoneycombCode
14400,14021,379,20,20[0.001],9999,[0.001],HoneycombCode
13600,13262,338,20,20[0.001],9999,[0.001],HoneycombCode
28800,28136,664,20,20[0.001],9999,[0.001],HoneycombCode
100,86,14,20,20[0.002],9999,[0.002],HoneycombCode
100,92,8,20,20[0.002],9999,[0.002],HoneycombCode
200,187,13,20,20[0.002],9999,[0.002],HoneycombCode
200,176,24,20,20[0.002],9999,[0.002],HoneycombCode
200,178,22,20,20[0.002],9999,[0.002],HoneycombCode
400,358,42,20,20[0.002],9999,[0.002],HoneycombCode
400,365,35,20,20[0.002],9999,[0.002],HoneycombCode
800,736,64,20,20[0.002],9999,[0.002],HoneycombCode
1200,1091,109,20,20[0.002],9999,[0.002],HoneycombCode
1200,1098,102,20,20[0.002],9999,[0.002],HoneycombCode
2400,2156,244,20,20[0.002],9999,[0.002],HoneycombCode
2400,2155,245,20,20[0.002],9999,[0.002],HoneycombCode
4800,4378,422,20,20[0.002],9999,[0.002],HoneycombCode
7200,6504,696,20,20[0.002],9999,[0.002],HoneycombCode
7200,6504,696,20,20[0.002],9999,[0.002],HoneycombCode
8689,7869,820,20,20[0.002],9999,[0.002],HoneycombCode
14400,12944,1456,20,20[0.002],9999,[0.002],HoneycombCode
13600,12325,1275,20,20[0.002],9999,[0.002],HoneycombCode
14400,13049,1351,20,20[0.002],9999,[0.002],HoneycombCode
20111,18199,1912,20,20[0.002],9999,[0.002],HoneycombCode
100,73,27,20,20[0.004],9999,[0.004],HoneycombCode
100,66,34,20,20[0.004],9999,[0.004],HoneycombCode
200,157,43,20,20[0.004],9999,[0.004],HoneycombCode
200,146,54,20,20[0.004],9999,[0.004],HoneycombCode
200,135,65,20,20[0.004],9999,[0.004],HoneycombCode
400,271,129,20,20[0.004],9999,[0.004],HoneycombCode
400,282,118,20,20[0.004],9999,[0.004],HoneycombCode
800,564,236,20,20[0.004],9999,[0.004],HoneycombCode
1200,867,333,20,20[0.004],9999,[0.004],HoneycombCode
1200,843,357,20,20[0.004],9999,[0.004],HoneycombCode
2400,1671,729,20,20[0.004],9999,[0.004],HoneycombCode
2400,1646,754,20,20[0.004],9999,[0.004],HoneycombCode
4800,3365,1435,20,20[0.004],9999,[0.004],HoneycombCode
3871,2656,1215,20,20[0.004],9999,[0.004],HoneycombCode
852,590,262,20,20[0.004],9999,[0.004],HoneycombCode
4045,2836,1209,20,20[0.004],9999,[0.004],HoneycombCode
7200,5058,2142,20,20[0.004],9999,[0.004],HoneycombCode
7200,4978,2222,20,20[0.004],9999,[0.004],HoneycombCode
5195,3589,1606,20,20[0.004],9999,[0.004],HoneycombCode
10355,7070,3285,20,20[0.004],9999,[0.004],HoneycombCode
8405,5820,2585,20,20[0.004],9999,[0.004],HoneycombCode
9316,6490,2826,20,20[0.004],9999,[0.004],HoneycombCode
10529,7377,3152,20,20[0.004],9999,[0.004],HoneycombCode
9316,6472,2844,20,20[0.004],9999,[0.004],HoneycombCode
9316,6414,2902,20,20[0.004],9999,[0.004],HoneycombCode
100,62,38,20,20[0.005],9999,[0.005],HoneycombCode
100,60,40,20,20[0.005],9999,[0.005],HoneycombCode
200,122,78,20,20[0.005],9999,[0.005],HoneycombCode
200,116,84,20,20[0.005],9999,[0.005],HoneycombCode
200,117,83,20,20[0.005],9999,[0.005],HoneycombCode
400,239,161,20,20[0.005],9999,[0.005],HoneycombCode
400,211,189,20,20[0.005],9999,[0.005],HoneycombCode
800,411,389,20,20[0.005],9999,[0.005],HoneycombCode
1200,702,498,20,20[0.005],9999,[0.005],HoneycombCode
1200,677,523,20,20[0.005],9999,[0.005],HoneycombCode
2400,1333,1067,20,20[0.005],9999,[0.005],HoneycombCode
2400,1397,1003,20,20[0.005],9999,[0.005],HoneycombCode
2091,1204,887,20,20[0.005],9999,[0.005],HoneycombCode
2159,1238,921,20,20[0.005],9999,[0.005],HoneycombCode
4800,2745,2055,20,20[0.005],9999,[0.005],HoneycombCode
3596,2013,1583,20,20[0.005],9999,[0.005],HoneycombCode
5109,2950,2159,20,20[0.005],9999,[0.005],HoneycombCode
405,233,172,20,20[0.005],9999,[0.005],HoneycombCode
5041,2908,2133,20,20[0.005],9999,[0.005],HoneycombCode
1002,564,438,20,20[0.005],9999,[0.005],HoneycombCode
5402,3137,2265,20,20[0.005],9999,[0.005],HoneycombCode
5604,3177,2427,20,20[0.005],9999,[0.005],HoneycombCode
5739,3266,2473,20,20[0.005],9999,[0.005],HoneycombCode
5402,3136,2266,20,20[0.005],9999,[0.005],HoneycombCode
285,164,121,20,20[0.005],9999,[0.005],HoneycombCode
5604,3182,2422,20,20[0.005],9999,[0.005],HoneycombCode
5803,3282,2521,20,20[0.005],9999,[0.005],HoneycombCode
587,328,259,20,20[0.005],9999,[0.005],HoneycombCode
431,258,173,20,20[0.005],9999,[0.005],HoneycombCode
858,503,355,20,20[0.005],9999,[0.005],HoneycombCode
1671,944,727,20,20[0.005],9999,[0.005],HoneycombCode
98,58,40,20,20[0.005],9999,[0.005],HoneycombCode
2106,1209,897,20,20[0.005],9999,[0.005],HoneycombCode
123,71,52,20,20[0.005],9999,[0.005],HoneycombCode
152,81,71,20,20[0.005],9999,[0.005],HoneycombCode
5252,2991,2261,20,20[0.005],9999,[0.005],HoneycombCode
4177,2371,1806,20,20[0.005],9999,[0.005],HoneycombCode
3314,1853,1461,20,20[0.005],9999,[0.005],HoneycombCode
3285,1879,1406,20,20[0.005],9999,[0.005],HoneycombCode
580,305,275,20,20[0.005],9999,[0.005],HoneycombCode
1535,834,701,20,20[0.005],9999,[0.005],HoneycombCode
3290,1898,1392,20,20[0.005],9999,[0.005],HoneycombCode